------------------------------------------------------------------------------------------------------------------------------------------------------
------------------------------------------------------------------------------------------------------------------------------------------------------
------------------------------------------------------------------------------------------------------------------------------------------------------
------------------------------------------------------------------------------------------------------------------------------------------------------
--------------------------------------------------U------------------------------------------------------------------2--------------------------------
------------------------------------------------------------------------------------------------------------------------------------------------------
--!--------------L-@-L-------o---------------C---11---------------U-----------------L-----@-----------------------------------------------------------
---------------------1--U-L-------------o-------------!-------------------------------------------------L------L--------!L-----L----------------------
------------o-----------L-------------------------------------------------------------2------------------1----------------1-----L------------------@--
--L--------C--------------------------------------------------------------------------------------C---------1--2--------------------------------@-----
-------------!----------------------------!---!----------!----L----------------U------------------------------------------------C---------------------
---------------------K-#----G------#------###----------#Y---#--------#----####--------k----#-----##--------------------------------------G---#-K------
------G--G----gY----k--#------g------------------#-----#-----------R--------#-k---#-------------R-G-----------#-K-----#---------------G-##---------#--
-M-----------k--Y#----R--------G-----#---y---#-------#---#--#R---------------#---y---------R------g-#---K#---#--g--y--------R-----------------#--#--F-
XXXX--XX---XXX-X--X-XX--X--X---X--X-X-----X--XXX-X---X--X-XXXX---XX-----X--XX-X-XXX--X-XXX-XXXX-X-X-XXXXXX---X-X-XXXX--X-X----XXX--X-XX-X--XXX-XX-XXXX
XXX-X-X--XXXXXXX-XX---X------X-X--XXX--X--X--X---XX-X------X-X--XXXX-X-X--X-XX----------X-X---X-------XX---X-XX--X-X---XX-XX------X-X--X-X------X-XXX-
