-------------------r--------------------2---------C------22--kF--|---gST-----------U---------X----------------F---|---------------k--------------S--%-
----U------------------t---2-------------------------------------2-----------------------U---|--------r---------U-U--------------------T--------------
--C---------S-------g----C-X------------------------------------%------r---Uk--C-------------------F-t-|-----------U--------------U---2-------T-----2-
--t----F---------------------------------C------tS-----------------------%--------F---------------------------------------------------X------%--------
-------S-------------------------------------------------|------------------------Sg------%U----2------C----------X--X--------T-----r-%----g--------T-
------------T------------U-----------------------2------C-C------U-------------------------------------------------|-------------T---------------g----
-g---------%-k------------------------T--------------------------r------r-------------g--------|--F---2---------------%--k-----------t----------2-----
--%----------U------------T------------T------rU-----2-----------------------S---------------------------------------F---|----------------------------
-%-----------g---2%--%-----g------T------k--------------------------k-------g-------C----C---------------------|-C------S%X-|--%C---------------------
----------------------|----------t2----|-r-------------------------g------------C--r-2-------------------------------------F--F---2-----gk-----------2
||--------gr----X-----|---g--------g------------------|U----------%-----g------------CXT--%--------%-------Cg-------------r%----|-----------------C---
--------S-----g-------------------k-----|------%-%-%---t------g-|%k---|-%----C----k------|-g-|gt--|----F-------%-------------------------------X------
-----r--------------F2-------------|--------2---------T--2------------k------T----|--T---r--|---|-|%%F---k---|--U--------X-kt-----U--U---%-----%------
---------|-%-%----F--%-%-%r------------------------------k--U--------------------S-------%--------F------Fgg---|g-F%-----|-------------U---%--%F%--%--
--||-|%--%t---%k%-%|---%%|tk|S|----%%t-X%%----%%|%-%-%|---%%k--k|-S%%--%-----%-%%%-%%---%%--------------------------------------t----g--------g-g-----
-%|-T-|g----%----%kg--2|--|---%%-||%--k-|---|-%--|-|g|--|--||-||-rS--%|%%|%-|||-T-r-||%---||t-%F%|2---%---|%||-|-|--%C-T-|-%||%%r--|---%-2--|---|2|---
