------------------------------------------------------------------------------------------------------------------------------------------------------
------------------------------------------------------------------------------------------------------------------------------------------------------
------------------------------------------------------------------------------------------------------------------------------------------------------
------------------------------------------------------------------------------------------------------------------------------------------------------
------------------------------------------------------------------------------------------------------------------------------------------------------
------------------------------------------------------------------------------------------------------------------------------------------------------
------------------------------------------------------------------------------------------------------------------------------------------------------
------------------------------------------------------------------------------------------------------------------------------------------------------
------------------------------------------------------------------------------------------------------------------------------------------------------
------------------------------------------------------------------------------------------------------------------------------------------------------
------------------------------------------------------------------------------------------------------------------------------------------------------
------------------------------------------------------------------------------------------------------------------------------------------------------
------------------------------------------------------------------------------------------------------------------------------------------------------
---------------------------------------------------------------%%%%%%%%--%%%%%%%%%%%-----------------------------%%%%%--------------------------%%%%%%
------%%%%%----------------------------------------------------|||||||||||||||||||||||--------------------------|||||||----------------------|||||||||
XXXXXX|||||XXXXXXXXXXXXXX----XXXXXXXXXXX-----XXXXXXXX--X||----|||||||||||||||||||||||||---X-----------|---||--|||||||||---|||---|--|--|--|||||||||||||
