------------------------------------------------------------------------------------------------------------------------------------------------------
------------------------------------------------------------------------------------------------------------------------------------------------------
------------------------------------------------------------------------------------------------------------------------------------------------------
------------------------------------------------------------------------------------------------------------------------------------------------------
------------------------------------------------------------------------------------------------------------------------------------------------------
------------------------------------------------------------------------------------------------------------------------------------------------------
------------------------------------------------------------------------------------------------------------------------------------------------------
------------------------------------------------------------------------------------------------------------------------------------------------------
------------------------------------------------------------------U-----------------------------------------------------------------------------------
---------------------------------------------------------------------------g--g------------------------------------------S--SSC---S-----g-------------
------------------------------------------k------------------------------------%%----------------------------------------g----------------%%%%%%%%%%%%
----------------------------------------gkgkgk--kg----%%%%%%%%%%%%%g%%%%%%%----||---g-gggkgggggggggggS-------------------------------g---|||||||||||||
------------------------------%%%%%%%-----------------||||--|||||||-|||||||---%%%%%%%----------------------------------------------------|||||||||||||
--------------------------gg--|||||||--------%%%%%%---%|||-|||||%%%%%%%%%%%%--|||||------------%---%%---------------------%--%---|---|---|%%%|||||||||
------%%%%%-------------------|||||||---%%%%%%S||||---|||||||||||||||||||||||-%%%%%%%%%-|------|-------------------------||--|---|---|---|||||||||||||
XXXXXX|||||XXXXXXXXXXXXXX---XXXXXXXXXXX||||||||||||XXXX||||||||||||||||||||-|-|||||||||||---XXXXXXXXXXXXXX--XXXXXXXXXXXXXXXXXXX-X||XX|XXX|||||||||||||
