------------------------------------------------------------------------------------------------------------------------------------------------------
------------------------------------------------------------------------------------------------------------------------------------------------------
------------------------------------------------------------------------------------------------------------------------------------------------------
------------------------------------------------------------------------------------------------------------------------------------------------------
------------------------------------------------------------------------------------------------------------------------------------------------------
------------------------------------------------------------------------------------------------------------------------------------------------------
------------------------------------------------------------------------------------------------------------------------------------------------------
------------------------------------------------------------------------------------------------------------------------------------------------------
------------------------------------------------------------------------------------------------------------------------------------------------------
------------------------------------------------------------------------------------------------------------------------------------------------------
------------------------------------------------------------------------------------------------------------------------------------------------------
------------------------------------------------------------------------------------------------------------------------------------------------%%%%%%
------------------------------------------------------------------------------------------------------------------------------------------------||||||
--------------------------------------------------%--%%%%%%%%%%%%%%%%%%%%%%%%-----------%-----%%%%-----------------------%%%%%%%%%%-%%%%%%%%%%%%%%||||
------%%%%%------------------------------------|%%|--||||||||||||||||||||||||%%%%%%%%%%||------|||-%%--%%%%-%%%%%%-------||||||-|||%||||||||||||||||||
XXXXXX|||||XXXXXXXXXXXXXX----XXXXXXXXXX--X-----||||--||||||||||||||||||||||||||||||||||||------|||-||-||||------|-----|-|||||||-||||||||||||||||||||||
