------------------------------------------------------------------------------------------------------------------------------------------------------
------------------------------------------------------------------------------------------------------------------------------------------------------
------------------------------------------------------------------------------------------------------------------------------------------------------
------------------------------------------------------------------------------------------------------------------------------------------------------
------------------------------------------------------------------------------------------------------------------------------------------------------
------------------------------------------------------------------------------------------------------------------------------------------------------
------------------------------------------------------------------------------------------------------------------------------------------------------
------------------------------------------------------------------------------------------------------------------------------------------------------
------------------------------------------------------------------------------------------------------------------------------------------------------
------------------------------------------------------------------------------------------------------------------------------------------------------
------------------------------------------------------------------------------------------------------------------------------------------------------
----------------------------------------------------------------------------------------------------------g%--%%%%%%%%--------------------------------
---------------------------------------------------%----------------------------------------------------------|||||||||-------------------------------
---------------------------------------------------|--------------%%-------%%%%%%%%%------------------|%--%%-%|||||||||-------------------------------
------%%%%%--------------%%----%%Xk----------------|--------------||-------|||||||||-------|%%----%--|||--||-||||||||||%-------%---||---%%%%----------
XXXXXX|||||XXXXXXXXXXXXXX||||||||||XXXXXXXXXXXXXXXXXXX----XXXXXXXX|||-----X|||||||XXXXXXXXXX|-----|XX|||-XXXX|||||||||||---|---||--||--|||||---------X
