------------------------------------------------------------------------------------------------------------------------------------------------------
------------------------------------------------------------------------------------------------------------------------------------------------------
------------------------------------------------------------------------------------------------------------------------------------------------------
------------------------------------------------------------------------------------------------------------------------------------------------------
------------------------------------------------------------------------------------------------------------------------------------------------------
------------------------------------------------------------------------------------------------------------------------------------------------------
------------------------------------------------------------------------------------------------------------------------------------------------------
------------------------------------------------------------------------------------------------------------------------------------------------------
------------------------------------------------------------------------------------------------------------------------------------------------------
------------------------------------------------------------------------------------------------------------------------------------------------------
----------------------------------g-------------------------------------------------------------------------------------------------------------------
------------------------------------gggk-gg-----------------------------------%%---------------------------------||-----------------------------------
-----------------------------------------------------------------------------||||--------------------------------|||----------------------------------
----------------------------------------------------------------%%%%%%-----%%%||%%%----------------------------%%|||----------------------------------
------%%%%%-----------------------k-----------------------------||||||-----||||||||----------------------------||||||---------------------------------
XXXXXX|||||XXXXXXXXXXXXXX---XXXXXXXXXXXXXXXXXXXXXXXXXXXXXXXXXXXX||||||-----||||||||-XXXXXXXXXX----XXXXXXXXXXXXX||||||-------------XXX--XXXXXX---------
