------------------------------------------------------------------------------------------------------------------------------------------------------
------------------------------------------------------------------------------------------------------------------------------------------------------
------------------------------------------------------------------------------------------------------------------------------------------------------
------------------------------------------------------------------------------------------------------------------------------------------------------
------------------------------------------------------------------------------------------------------------------------------------------------------
------------------------------------------------------------------------------------------------------------------------------------------------------
------------------------------------------------------------------------------------------------------------------------------------------------------
------------------------------------------------------------------------------------------------------------------------------------------------------
------------------------------------------------------------------------------------------------------------------------------------------------------
------------------------------------------------------------------------------------------------------------------------------------------------------
----------------------------------g-------------------------------------------------------------------------------------------------------------------
--------------------------------------g---------------------------------------------------------------------------------------------------------------
-----------------------------------------------------------------%%%%%-----%%%%%%|--------------------------------|-----------------------------------
--------------------------------%%------------------------------||||||----%|||||%%%%%----------------------------%%%----------------------------------
------%%%%%---------------------|||-----------------------------||||||----|||||||||||----------------------------|||----------------------------------
XXXXXX|||||XXXXXXXXXXXXXX----XXXXXXXXX-XX--XXXXXXXXXXXXXXXX-XXXX|||||||---||||||||||-XXXXXXXXX--XXXXXXXXXXXXXXXXX|||--------X-----X------X------------
