------------------------------------------------------------------------------------------------------------------------------------------------------
------------------------------------------------------------------------------------------------------------------------------------------------------
------------------------------------------------------------------------------------------------------------------------------------------------------
------------------------------------------------------------------------------------------------------------------------------------------------------
------------------------------------------------------------------------------------------------------------------------------------------------------
------------------------------------------------------------------------------------------------------------------------------------------------------
------------------------------------------------------------------------------------------------------------------------------------------------------
------------------------------------------------------------------------------------------------------------------------------------------------------
------------------------------------------------------------------------------------------------------------------------------------------------------
--------------------------------------CSSCSCCC------------------------------------------gk--------------------------------------------------g-S-------
--------------------------------------------------------------------------------------------------%-----------------%%%%%%%%%%%%%%%%%%%%%%%-----------
-----------------------------------g------------------------------------------g-----------------------%%%%%%%%%%%%%%%|||||-|||||||||||||||------------
---------------------------------------------%%%%%%%%------------------------------------%%%%%%%%%%%%%||||||||||||||||||F%%%%%%%%%%%%%%|%|%2%---------
--------------------------------------g-------|-|||||%%----------------------------------||||||||||||||||||||||||||||||||||||||||||||||||||||---------
------%%%%%--------------------%%---------------||||||-----------------------------------|||||||||||||||||||||||||||||||||||||||||||||||||%%%%%%%%%---
XXXXXX|||||XXXXXXXXXXXXXX-----|||||XXXXXXXXXXXXXXX|||||----|--XXXXXXXXXXXXXXXXXXXXXXXXXXX||||||||||||||||||||||||||||||||||||||||||||||||||||||||||---
