------------------------------------------------------------------------------------------------------------------------------------------------------
------------------------------------------------------------------------------------------------------------------------------------------------------
------------------------------------------------------------------------------------------------------------------------------------------------------
------------------------------------------------------------------------------------------------------------------------------------------------------
------------------------------------------------------------------------------------------------------------------------------------------------------
------------------------------------------------------------------------------------------------------------------------------------------------------
------------------------------------------------------------------------------------------------------------------------------------------------------
------------------------------------------------------------------------------------------------------------------------------------------------------
------------------------------------------------------------------------------------------------------------------------------------------------------
--------------------------------------------------------g---------------------------------------------------------------------------------------------
----------------------------------------------------------ggg---------------------------ggggg-------------------------g-----------------%%%%----------
---------------------------------------------------------------------------------------g-------%--%%-%%%%-----------------|-%%%%%%%%%%%%%%%%%%%%%%--%%
----------------------------------------------------------------------------------------------|||-||---|||--%%%%%|%-%%%%X%%%|||||||||||||||||||||---||
---------------------------------------------|%%%%%%%%%%%%%%%%%%%-----%%----------------%%%%%%||%%%%%%%%%%%%|||||||---||||||||||||||||||||||||||||--||
------%%%%%---------------------------------||||||||||||||||||||-------|--------------%-||||||||||||||||||||||||%%%%%%%|||||||||||||||||||||||||||%|||
XXXXXX|||||XXXXXXXXXXXXXX-----XXXXXXXXXXXXXX||||||||||||||||||||-X--XXXXX----XXXXXXXXX||||||||||||||||||||||||||||||||||||||||||||||||||||||||||||||||
