------------------------------------------------------------------------------------------------------------------------------------------------------
------------------------------------------------------------------------------------------------------------------------------------------------------
------------------------------------------------------------------------------------------------------------------------------------------------------
------------------------------------------------------------------------------------------------------------------------------------------------------
------------------------------------------------------------------------------------------------------------------------------------------------------
------------------------------------------------------------------------------------------------------------------------------------------------------
------------------------------------------------------------------------------------------------------------------------------------------------------
------------------------------------------------------------------------------------------------------------------------------------------------------
------------------------------------------------------------------------------------------------------------------------------------------------------
------------------------------------------------------------------------------------------------------------------------------------------------------
------------------------------------------------------------------------------------------------------------------------------------------------------
------------------------------------------------------------------------------------------------------------------g-----------------------------------
-------------------------------------------------------------------------------|---------------------------------|------------------------------------
--------------------------------|-------------------------------%%%%%%-----%%||||-------------------------------||||----------------------------------
------%%%%%---------------------|------------------------------||||||||---|||||||||----------------------------|||||||------------------|||-----------
XXXXXX|||||XXXXXXXXXXXXXX---XXXXXXXXXXXXXXXXXXXXXXXXXXXXX-XXXXX||||||||---||||||||||XXXXXXXXXXX--XXXXXXXXXXXXXX||||||||||||--XX--XXXXXXX||||XXXX-X-|XX
