------------------------------------------------------------------------------------------------------------------------------------------------------
------------------------------------------------------------------------------------------------------------------------------------------------------
------------------------------------------------------------------------------------------------------------------------------------------------------
------------------------------------------------------------------------------------------------------------------------------------------------------
------------------------------------------------------------------------------------------------------------------------------------------------------
------------------------------------------------------------------------------------------------------------------------------------------------------
------------------------------------------------------------------------------------------------------------------------------------------------------
------------------------------------------------------------------------------------------------------------------------------------------------------
------------------------------------------------------------------------------------------------------------------------------------------------------
------------------------------------------------------C-SSSSgS---------------------------------------------------------------------------------%%%%%%%
--------------------------------------------Sg-------------------------------------------------------------------------------------------------||||||-
---------------------------------------------------------------------------------------------%%%%%-%%-------------------%---%%%%%%%%%%%%%%%%%%%%%%%%%%
----------------------------------------------------%%%%%%%%%%-------------------------------|||||-|%%%%%%%%%%%%-----------|||||||||||||||||||||||||||
-------------------------------%%----%-----%%%%%%%%|||||||||||%--------|%----------%%%%%%%%%%%%%||||||||||||||||----%%%%%%%|||||||||||||||||||||||||||
------%%%%%--------------------------|-----||||||||||||||||||||-----%%%%%%%-------||||||||||||||||||||||||||||||--%%||||||||||||||||||||||||||||||||||
XXXXXX|||||XXXXXXXXXXXXXX-----XXXXXXXXXXXXX|||||||||||||||||||||----||||||||------|||||||||||||||||||||||||||||||-||||||||||||||||||||||||||||||||||||
