------------------------------------------------------------------------------------------------------------------------------------------------------
------------------------------------------------------------------------------------------------------------------------------------------------------
------------------------------------------------------------------------------------------------------------------------------------------------------
------------------------------------------------------------------------------------------------------------------------------------------------------
------------------------------------------------------------------------------------------------------------------------------------------------------
------------------------------------------------------------------------------------------------------------------------------------------------------
------------------------------------------------------------------------------------------------------------------------------------------------------
------------------------------------------------------------------------------------------------------------------------------------------------------
------------------------------------------------------------------------------------------------------------------------------------------------------
--------------------------------------------------------g---------------------------------------------------------------------------------------------
--------------------------------------------Sg------------ggg---------------------------ggggg-------------------------g--------------------%----------
------------------------------------------------------------|--g----------------------gg------%%--%%--%%--------------------%%%%-%%--%%%%%%%%%%%%%%%%%
----------------------------------------------------------------------------------------------||--|---------%%%%%-%----%X%%%||||||||||||||||||||||--||
---------------------------------------------%%%%%%%%%%%%%%%%%%%%%---%%%%---------------%%%%%%%%%%%%%%%%%%%-|||||------|||||||||||||||||||||||||||-%||
------%%%%%---------------------------------||||||||||||||||||||||---||||------------%%|||||||||||||||||||||%%%%%%%%%%%%||||||||||||||||||||||||||||||
XXXXXX|||||XXXXXXXXXXXXXX----XXXXXXXXXXXXXXX||||||||||||||||||||||---XX|------XXXXX---||||||||||||||||||||||||||||||||||||||||||||||||||||||||||||||||
