------------------------------------------------------------------------------------------------------------------------------------------------------
------------------------------------------------------------------------------------------------------------------------------------------------------
------------------------------------------------------------------------------------------------------------------------------------------------------
------------------------------------------------------------------------------------------------------------------------------------------------------
------------------------------------------------------------------------------------------------------------------------------------------------------
------------------------------------------------------------------------------------------------------------------------------------------------------
------------------------------------------------------------------------------------------------------------------------------------------------------
------------------------------------------------------------------------------------------------------------------------------------------------------
------------------------------------------------------------------------------------------------------------------------------------------------------
------------------------------------------------------------------------------------------------------------------------------------------------------
-----------------------------------------------------------------------------------------------------------------------------------------------%%%%%%%
---------------------------------------------------------------------------------------g---gg----------------------------------------------%%%||||||||
-------------------------------------------------------%%%--%%%%-------%%%%----------------------------------------------------------------|||||||||||
--------------------------------%|-||------%%%%%%%%--%%||||||||||%%%%%%||||%------||||%%%%%%-%-%%%--%------------------%%%%%%%%%%%%%%%%%%%%%||||||||||
------%%%%%--------------------||||||------||||||||-|||||||||||||||||||||||||--%%%%|||||||||--||||-|||%%%%%-%%--------||||||||||||||||||||||||||||||||
XXXXXX|||||XXXXXXXXXXXXXX---XXXXXXXXXXX---|||||||||||||||||||||||||||||||||||--|||||||||||||--|||||||||||||-||------XX||||||||||||||||||||||||||||||||
