------------------------------------------------------------------------------------------------------------------------------------------------------
------------------------------------------------------------------------------------------------------------------------------------------------------
------------------------------------------------------------------------------------------------------------------------------------------------------
------------------------------------------------------------------------------------------------------------------------------------------------------
------------------------------------------------------------------------------------------------------------------------------------------------------
------------------------------------------------------------------------------------------------------------------------------------------------------
------------------------------------------------------------------------------------------------------------------------------------------------------
------------------------------------------------------------------------------------------------------------------------------------------------------
------------------------------------------------------------------------------------------------------------------------------------------------------
------------------------------------------------------------------------------------------------------------------------------------------------------
------------------------------------------------------------------------------------------------------------------------------------------------------
-------------------------------------gg-ggkg-gg------------------------------------%------------------------------g-g---------------------------------
--------------------------------%%%-----------------------------%%%%%%%---%%%%%%%%%|------------------------------------------------------------------
--------------------------------|||----------------------------||||||||--|||||||||||||----------------------------%--------------------------------|--
------%%%%%--------------------||||---%%-----------------------||||||||-||||||||||||||----------------------------|--------------------------------|--
XXXXXX|||||XXXXXXXXXXXXXX---XXXXXXXXX||||--XX-XXXXXXXXXXXXXXXXX||||||||-||||||||||||||-XXXXXXXXXXXXXXXXXXXXXXXXXXXXXXX--XXXXXXXXXXXXXXXXXXXXX--X---||X
