------------------------------------------------------------------------------------------------------------------------------------------------------
------------------------------------------------------------------------------------------------------------------------------------------------------
------------------------------------------------------------------------------------------------------------------------------------------------------
------------------------------------------------------------------------------------------------------------------------------------------------------
------------------------------------------------------------------------------------------------------------------------------------------------------
------------------------------------------------------------------------------------------------------------------------------------------------------
------------------------------------------------------------------------------------------------------------------------------------------------------
------------------------------------------------------------------------------------------------------------------------------------------------------
------------------------------------------------------------------US----------------------------------------------------------------------------------
----------------------------------------------------------------------------------------------------------------------------SS------------------------
------------------------------------------------------------------------------%%%----------------------------------------------------------%%%%%%%-%%%
---------------------------------------ggkgkkk--k-------%%--%%%%%%%%%%%%%%%----|--------gg--gggg-ggg----------------------------------------|||-||-|||
------------------------------%%%%%%%-------------------||--|||||||||||||||-%%%%%%%%%%-------------------------------------------------------||-||-|||
--------------------------gg--|||||||------------------%||--||||||||||||%|||||||||||------------------------------------------------------%--%%%||||||
------%%%%%-------------------|||||||---%%%%%%S-%------|||--%||||||||||||||||%||%%%%%%%---------------------------------------------------|--||-||-||%
XXXXXX|||||XXXXXXXXXXXXXX---XXXXXXXXXXX-|||||||||XXXXXXX||--|||||||||||||||||||||||||||---XXXXXXXXXXXXXXXXXXXXXXXXXXXXXXXXXXXXXXXXX--XXXXXXXX||-||||||
