------------------------------------------------------------------------------------------------------------------------------------------------------
------------------------------------------------------------------------------------------------------------------------------------------------------
------------------------------------------------------------------------------------------------------------------------------------------------------
------------------------------------------------------------------------------------------------------------------------------------------------------
------------------------------------------------------------------------------------------------------------------------------------------------------
------------------------------------------------------------------------------------------------------------------------------------------------------
------------------------------------------------------------------------------------------------------------------------------------------------------
------------------------------------------------------------------------------------------------------------------------------------------------------
------------------------------------------------------------------------------------------------------------------------------------------------------
------------------------------------------------------------------------------------------------------------------------------------------------------
------------------------------------------------------------------------------------------------------------------------------------------------------
----------------------------------------------------------------------------------------------------------%%%%%%%%%%%%g%%--||-------g-----------------
-------------------------------------------------%%%%---------------------------------%%--%%%%--%%%%%%%%%%|||||||||||||||--||--||--||--|---2%%%%%%%%%k
------------------------------%%%%%--%%-----------|||----------------------%%%%%%%%%%%%|-|||||--||||||||||||||||||||||||||-||||||-|||-|||------||||||-
------%%%%%-------------------||||---||-----------|||----%|-------%%%%%%%%%||||-||||||||-||||||-%%%%%|||||||||||||||||||||-|||||||||||||||%%%%%%%||||-
XXXXXX|||||XXXXXXXXXXXXXX-----XXXXXXXXXXX-XXXXXXXX||||----|-------|||||||||||||-||||||||||||||||||||||||||||||||||||||||||-|||||||||||||||||||||||||||
