------------------------------------------------------------------------------------------------------------------------------------------------------
------------------------------------------------------------------------------------------------------------------------------------------------------
------------------------------------------------------------------------------------------------------------------------------------------------------
------------------------------------------------------------------------------------------------------------------------------------------------------
------------------------------------------------------------------------------------------------------------------------------------------------------
------------------------------------------------------------------------------------------------------------------------------------------------------
------------------------------------------------------------------------------------------------------------------------------------------------------
------------------------------------------------------------------------------------------------------------------------------------------------------
------------------------------------------------------------------------------------------------------------------------------------------------------
------------------------------------------------------------------------------------------------------------------------------------------------------
----------------------------------------------------------------------------------------------------------------%%%%------g---------------------------
--------------------------------%%%%gggggggggggkgggg--gkg-----g-%%%%%%---ggg%%%%%%%%g------------------ggg------||g-----------------------------------
-------------------------%%%%%%%||||----------------------------||||||------||||||||-----------------------------||-----------------------------------
-------------------------||||-|||||----------------------------%|||||%%---%|||||||||----------------------------|||-----------------------------------
------%%%%%--------------|%|||||||k%-%%%%%%%%------------------||||||||---||||||||||----------------------------|||-----------------------------------
XXXXXX|||||XXXXXXXXXXXXXX|||||||||||||||||XXX-XXXXXXXXXXXXXXXXXX||||||XXXXX||||||||XXXXXXXXXXXXXXXXXXXXXXXXXXXXXX|XXX--XXXXXXXXXXXXXXXXXXXXXXXXXXXXXXX
