------------------------------------------------------------------------------------------------------------------------------------------------------
------------------------------------------------------------------------------------------------------------------------------------------------------
------------------------------------------------------------------------------------------------------------------------------------------------------
------------------------------------------------------------------------------------------------------------------------------------------------------
------------------------------------------------------------------------------------------------------------------------------------------------------
------------------------------------------------------------------------------------------------------------------------------------------------------
------------------------------------------------------------------------------------------------------------------------------------------------------
------------------------------------------------------------------------------------------------------------------------------------------------------
------------------------------------------------------------------------------------------------------------------------------------------------------
------------------------------------------------------------------------------------------------------------------------------------------------------
------------------------------------------------------------------------------------------------------------------------------------------------%%%%%-
------------------------------------------------------------------------------------------g----------------------------------------------------|||||%|
-------------------------------------------------------------%%%%%%%%%%%%%%%%%----%%%---------------------------------------------------------||||||||
--------------------------------%%%%-------------------%%%%-||||||||||||||||||--%%%%%%%%%-------%-----------------------%%%%%%%%%%%%%%%%%%%%%%||||||||
------%%%%%---------------------||||----------S-%%----%%|||-%|||||||||||||||||%||||||||||-------||--%%%%%%%---------------||||--|||--|||||||||||||||||
XXXXXX|||||XXXXXXXXXXXXXX----XXXXXXXXX-------||||||---|||||||||||||||||||||||||||||||||||-|----X||--||--||||---------XXXXXX|||--|||--|||-|||||||||||||
