------------------------------------------------------------------------------------------------------------------------------------------------------
------------------------------------------------------------------------------------------------------------------------------------------------------
------------------------------------------------------------------------------------------------------------------------------------------------------
------------------------------------------------------------------------------------------------------------------------------------------------------
------------------------------------------------------------------------------------------------------------------------------------------------------
------------------------------------------------------------------------------------------------------------------------------------------------------
------------------------------------------------------------------------------------------------------------------------------------------------------
---------------------------------------------------------------------------------------------------------------------------------------------g--g-----
-------------------------------------------------------------------------------------------r------------------%---Uk--g%--r-%--U%-----S---g-----------
---------------------------------------------------------------g-----------------gg%--------|g-ggg-g%gg%%%%%%%-|--------g------g--kg------U---------g-
---------------------------------------------------------------%%%%%%%%%%%%%%%-----------------------||---||--||--%%%%%---------------------------%%--
--------------------------------%%%%-%kgkg%ggggggk-gggkgkggg---||||||||-||||||%%%%%%%%%%%%%----------|g-g-g|--|||||||||Sg---g--g--k-g-gg----------||--
-------------------------%%%%%%%||||-||-|||||-|----------------||||||||-|||||||||||||||||||---------------||---|--|||||-------------------------------
-------------------------|||||||||||-||-|||||-|-----------------|||||||-|||||||||||||||||||---------------|------||||||---------------------------|---
------%%%%%--------------|||||||||||||%%%%||||||----------------|||||||-|||||||||||||||||||----------------------||||||-------------------------------
XXXXXX|||||XXXXXXXXXXXXXX|||||||||||||||||||XXXXXXXXXXXXXXXXXXXXX||||||XX|||||||||||||XXXXXXXXXXXXXXXXXXXXXXXXXXXXXXXXXXXXXXXXXXXXXXXXXXXXXXXXXXXXXXXX
