------------------------------------------------------------------------------------------------------------------------------------------------------
------------------------------------------------------------------------------------------------------------------------------------------------------
------------------------------------------------------------------------------------------------------------------------------------------------------
------------------------------------------------------------------------------------------------------------------------------------------------------
------------------------------------------------------------------------------------------------------------------------------------------------------
------------------------------------------------------------------------------------------------------------------------------------------------------
------------------------------------------------------------------------------------------------------------------------------------------------------
------------------------------------------------------------------------------------------------------------------------------------------------------
------------------------------------------------------------------------------------------------------------------------------------------------------
------------------------------------------------------------------------------------------------------------------------------------------------------
------------------------------------------------------------------------------------------------------------------------------------------------------
---------------------------------------------------------------------------------------------------------------------------------------------------%|-
---------------------------------------------------------------%%%%%%%%%--%%%%%%%%%%%-------------------------------------------------------------|||-
--------------------------------%%%%--------------------------||||||||||||||||||||||||%------------------------------------------------------%%%||||||
------%%%%%---------------------||||---------------------|----|||||||||||||||||||||||||-------------------------------------------|----------|||||||||
XXXXXX|||||XXXXXXXXXXXXXX----XXXXXXXXX---------XXXX----|||----||||||||||||||||||||||||||--XX--XXXX--------------X-----XXXXXXX---X-----------||||||||||
