------------------------------------------------------------------------------------------------------------------------------------------------------
------------------------------------------------------------------------------------------------------------------------------------------------------
------------------------------------------------------------------------------------------------------------------------------------------------------
------------------------------------------------------------------------------------------------------------------------------------------------------
-------------------------------------------------------------------------------------------------SC---------%-------------------------------CC-SS---g%
-----------------------------------------------------------------g%--------------------%%%S%-%S--------%%%-------C%---------gg%k%------SCS------------
---------------------------------------------------------------------------------%%C%%--|-|%%-------%|||||%C----------2Ck|C------|--%|----------------
---------------------------------------------------------------------------------|||-S-----------|--||||||||S%%%%---%%%|--|------|%%|%----%%%%%%%%%%%%
-------------------------------gS-UT-CS-CSC--SCS22%S%SCSSS-gg--g%2%%%%%%%%%%|%%-------%%%g|||%%%%-|%%--|||-||||-|||||-|%%%%%%%%%%-||||%%%%%-||||||||||
--------------------------g--------------gg-------||||--------%g||g|||||||||||||%%%%%-||||||g||||||%||%|%%%|||-|||||||||||||||||||||||||||||||||||||||
----------r---------------------------X|g|%%-------k|--------|||||||||||||||||||||||||||||%%||||||||||||||||||||||||||||||||||||||||||||||||%%%%%%%%%%
-------------------------%%%%%%%%%%%%%%%g%%%%%%%%%%%%gggggggg%|||||||||||||||||||||||||||||||||||||||||||||||||||Sg|||||||||||||||||||||||||||||||||||
-------------------------||||||||||||||||||||||||||||||||||||||||||||||||||||||||||||||||||||||||||||||||||||||-|---||||||||||||||||-||-|-|||S||||-|||
-------------------------|||||||||||||||||||||||||||||||||||||||||||||||||||||||||||||||||||||||-||||||||||||||-|---|||||||--|||-|---||-||-||||||----|
------%%%%%--------------||||||||||||||||||||||||||-||||||||||||||||||||||||||||||||||||||||||||--|||||-|||-|||-|-----|-|||---|------------|||-------|
XXXXXX|||||XXXXXXXXXXXXXX||||||||||||||||||||||||XXXXXXXXXXXXXXXXXXXXXXXXXXXXXXXX|||||||||XXXXXXXXXXXXXXXXXXXXXXXXXXXXXXXXXXXXXXXXXXXXXXXXXXXXXXXXXXXX
