------------------------------------------------------------------------------------------------------------------------------------------------------
------------------------------------------------------------------------------------------------------------------------------------------------------
------------------------------------------------------------------------------------------------------------------------------------------------------
------------------------------------------------------------------------------------------------------------------------------------------------------
--------------------------------------------------------------------------------------------------C------------S-C--------%--S------------------------
--------------------------------------------------------------------------------U------------%----------%%--------------------------------------------
--------------------------------------------------------------------%----------------%--|gggkC%----------------------%2--||-----S|SkS|---|%--%%-------
-------------------------------2-------------------------%-----------------------%%-|||----------||-|---||%-S%S%S-----|--||--%---||-----------||-%%---
-----------------------------------------------S------g--%----%|gU-|----%-----%------|--||-----|%%|%%-||||-|g|---||-g---g||-g-g-----%%%%%%%--%|%%%|%%%
----------------------------------------%-g----gg-g||gggg|---%|||--||%%||%%%g-||||--|-------g-||||||||||||||||---|gCS%%%%%%%%%%%%%%%||||||||||||||||||
--------------------------------r---kgkgg%%%g-----||||||--|k-|||----|||||||||-||%%%%%%%%%%%%%%|||||||||||||||g%g-|-||||||||||||||||||||||||%%%%%%|||||
-------------------------%%%%%%%%%%%|--|||||||%%%%|||||%%%%%|||ggggggg||||||kg|||||||||||||||||||||||||||||||||-|Sg--|||||||||||||||||||||||||||||||||
-------------------------|||||||||||||-|||||||||||||||||||||||||||--|||||||-----|||||||||||||||||||||||||||||||-------||||||||||||||||||||||||||||||||
-------------------------|||||||||||||%|%%%||||||||||||||||||||||----||||||-----|||||||||||||||||||||||||||||||-|-----||||||||||||||||||||||||||||||||
------%%%%%--------------|||||||||||||||||||||||||||||||||||||||||---||||||------||||||||||||||||||||||||||||||-|------|||||||||||||||||||||||||||||||
XXXXXX|||||XXXXXXXXXXXXXX|||||||||||||||||||||||||||||||||||||||XXXXXXXXXXXXXXXXXXX|||||||||X|||XX||||XX||||||XXXXXXXXX|||||X||XX||XX||X|||||||||XXX||
