------------------------------------------------------------------------------------------------------------------------------------------------------
------------------------------------------------------------------------------------------------------------------------------------------------------
------------------------------------------------------------------------------------------------------------------------------------------------------
------------------------------------------------------------------------------------------------------------------------------------------------------
------------------------------------------------------------------------------------------------------------------------------------------------------
------------------------------------------------------------------------------------------------------------------------------------------------------
------------------------------------------------------------------------------------------------------------------------------------------------------
------------------------------------------------------------------------------------------------------------------------------------------------------
------------------------------------------------------------------------------------------------------------------------------------------------------
-----------------------------------------------------CCSSSSSgS---------------------------------------------------------------------------------%%%%%%%
--------------------------------------------Sg-------------------------------------------------------------------------------------------------|||||||
-------------------------------------------------------------------------------------------%%%%%%%%%%%%---------------k%%--|%%%%%%%%%%%%%%%%%%%%%%%%%%
-------------------------------------------------%%%%%%%%%%%%%-----------------------------||||||||||||%%%%%%%%%----%%||||||||||||||||||||||||||||||||
-------------------------------%%----%-----%%%%%%||||||||||||||--------|%----------%%%%%%%%%%%||||||||||||||||||---|||||||||||||||||||||||||||||||||||
------%%%%%---------------------|----|-----||||||||||||||||||||------%%||%%--------||||||||||||||||||||||||||||||-||||||||||||||||||||||||||||||||||||
XXXXXX|||||XXXXXXXXXXXXXX-----XXXXXXXXXXXXX||||||||||||||||||||-----|||||||-----XX||||||||||||||||||||||||||||||||||||||||||||||||||||||||||||||||||||
