------------------------------------------------------------------------------------------------------------------------------------------------------
------------------------------------------------------------------------------------------------------------------------------------------------------
------------------------------------------------------------------------------------------------------------------------------------------------------
------------------------------------------------------------------------------------------------------------------------------------------------------
------------------------------------------------------------------------------------------------------------------------------------------------------
------------------------------------------------------------------------------------------------------------------------------------------------------
------------------------------------------------------------------------------------------------------------------------------------------------------
------------------------------------------------------------------------------------------------------------------------------------------------------
------------------------------------------------------------------------------------------------------------------------------------------------------
------------------------------------------------------------------------------------------------------------------------------------------------------
----------------------------------------------------------------------------------------------g---------%---%%%%%%%%------g-------%----%%%%%----------
-------------------------------%%%-ggk--g---gg--%%g%--------ggg-gkgkg--gg--g--%%%%-ggg-------------|-Sgg|gg-|||||||||------------------||||-----------
--------------------------------|------%%%--%%--||||--------------------------|||----------------------||----|||||||||------------------|||-----------
--------------------------------|------|||--||--||||-----------%%%%%----------|||--------------|---|%%%%%%---||||||||---------|-----||--|||-----------
------%%%%%--------------|%|X-|%%Xk%------------||||-------------|||----------|||-----------|%||--||--||||---|||||||%%%%%%%---%-----||--||||----------
XXXXXX|||||XXXXXXXXXXXXXX||||||||||||XXXXXXXXXXXXXXXXXXXXXXXXXXXXXXXXXXXXXXXXXXXXXXXXXXXXXXXXX||--XXXXXXXXXXX||||||||||||||--||--XXX|XXX|||XXXXXXXXXXX
