------------------------------------------------------------------------------------------------------------------------------------------------------
------------------------------------------------------------------------------------------------------------------------------------------------------
------------------------------------------------------------------------------------------------------------------------------------------------------
------------------------------------------------------------------------------------------------------------------------------------------------------
------------------------------------------------------------------------------------------------------------------------------------------------------
------------------------------------------------------------------------------------------------------------------------------------------------------
------------------------------------------------------------------------------------------------------------------------------------------------------
-----------------------------------------------------------------------------------------------------------------------g------%-----------------------
----------------------------------------------------------g--g---------------------%-%--------------------------g-------------||---|--------k--g------
--------------------------------------gSCCSCkgk-------------------------------------|-g%gkSg--------------------%%-------------------------|||S-------
----------------------------------------------------------------------------------------||-||-gg%%%%%%%%%%%%%%%%%|%%%%%%%%%%%%%%%%%%%%%%%%%||---------
--------------------------------%%-g------------%%%%%%%---kk----------------ggggggggkg-%|---|||||||||||||||||||||||||||||||||||||||||||||||||---------
---------------------------------------%%%%|%%%%|||||||--------------------------------||%%%%%%%%||||||||||||||||||||||||||||||||||||||||||||---------
-------------------------%%%%%%%------g||||||||||||||||------------------------%-------||||||||||||||||||||||||||||||||||||||||||||||||||||||---------
------%%%%%--------------|||||||%Xk%|-|||||||||||||||||--------------------------------||||||||||||||||||||||||||||||||||||||||||||||||||||||%-%------
XXXXXX|||||XXXXXXXXXXXXXX|||||||||||||XXXXXXXXXXXXX|||X--XXXXXXXXXXXXXXXXXXXXXXXXXXXXXXXX|||||||||||||||||||||||||||||||||||||||||||||||||||||XXXXXXXX
