------------------------------------------------------------------------------------------------------------------------------------------------------
------------------------------------------------------------------------------------------------------------------------------------------------------
------------------------------------------------------------------------------------------------------------------------------------------------------
------------------------------------------------------------------------------------------------------------------------------------------------------
------------------------------------------------------------------------------------------------------------------------------------------------------
------------------------------------------------------------------------------------------------------------------------------------------------------
-------------------------------------------------------------------------------------------------------------------------------S-------------CS-------
------------------------------------------------------------------------------------------------------------------------------------------------------
------------------------------------------------------------------------------------------------g-------gk-g------------------------------------------
------------------------------------------------%%%%gCCSS%SSgS--------ggg---------------------------------------------------------------%%%%%%%%%%%%%%
-------------------------------------ggSSSCgS--------------g-g----------------------kggg-ggg------------------------------|--------------|||||||||||||
-------------------------------------------------------|||-||--------------------------g--%%%%%%%%%%%%%%--------------X%%|||%%%%%%%%%%%%%%%%%%%|||||||
-----------------------------------------------%%%%%%%%%%%%%%%----------|------------%%%%|||||||||||||||%%%%%%%%%----%||||||||||||||||||||||||||||||||
--------------------------g---%%%-%%%%-%%%%%%%%||||||||||||||||-------%||----------%%|||||||||||||||||||||||||||----||||||||||||||||||||||||||||||||||
------%%%%%-------------------|||-||||-|||||||||||||||||||||||||------||||---------||||||||||||||||||||||||||||||--%||||||||||||||||||||||||||||||||||
XXXXXX|||||XXXXXXXXXXXXXX-----XXXXXXXXXXXX||||||||||||||||||||||---XXX||||-----XXX|||||||||||||||||||||||||||||||-||||||||||||||||||||||||||||||||||||
