------------------------------------------------------------------------------------------------------------------------------------------------------
------------------------------------------------------------------------------------------------------------------------------------------------------
------------------------------------------------------------------------------------------------------------------------------------------------------
------------------------------------------------------------------------------------------------------------------------------------------------------
------------------------------------------------------------------------------------------------------------------------------------------------------
------------------------------------------------------------------------------------------------------------------------------------------------------
------------------------------------------------------------------------------------------------------------------------------------------------------
------------------------------------------------------------------------------------------------------------------------------------------------------
---------------------------------------------------------------------------------------------------------------------------------%--------------------
------------------------------------------------------------------------------------------------------------------------------------------------------
------------------------------------------------------------------------------------------------------------------------------------------------------
--------------------------------------------------------------------------------------------------------------------------------------------------%---
------------------------------------------------------------------------------------------------------%%%%%%---------------%%%%%%%%%%%%%%-%2%%%%%%%%%k
----------------------------------------------%%%%%%%%%%%%%%%%---------------------%%%%%%%%%%%%%%%%%%%||||%%%%%%%%%%%%%%%%%|||||||||||||||||||||||||||
------%%%%%-----------------------------------||||||||||||||||---%%%%%%%%%%|-%-----|||||||||||||||||||||||||||||||||||||||||||||||||||||||||||||||||||
XXXXXX|||||XXXXXXXXXXXXXX-----XXXXXXXXXXXXXXXXX||||||||||||||||---||||||||||||-----|||||||||||||||||||||||||||||||||||||||||||||||||||||||||||||||||||
