------------------------------------------------------------------------------------------------------------------------------------------------------
------------------------------------------------------------------------------------------------------------------------------------------------------
------------------------------------------------------------------------------------------------------------------------------------------------------
------------------------------------------------------------------------------------------------------------------------------------------------------
------------------------------------------------------------------------------------------------------------------------------------------------------
------------------------------------------------------------------------------------------------------------------------------------------------------
------------------------------------------------------------------------------------------------------------------------------------------------------
------------------------------------------------------------------------------------------------------------------------------------------------------
------------------------------------------------------------------------------------------------------------------------------------------------------
------------------------------------------------------------------------------------------------------------------------------------------------------
------------------------------------------------------------------------------------------------------------------------------------------------------
--------------------------------------------------------------------------------------ggg---g---------------------------------------------%%%%%%%%%%%%
------------------------------------------------------------------------------------------------------------------------------------------||||||||||||
-----------------------------------|--------%%%%%%%%%%%%%%%%%%%%%%%%%%%%%%%%-----------%%%---%%%%%%%%-------------------%%%%%%%%%%%-%%%%%%%%||||||||||
------%%%%%------------------------||-------||||||||||||||||||||||||||||||||--%%%%%%%%%|||----|||||||--%%%%-%%%%%%------||||||||||||||||||||||||||||||
XXXXXX|||||XXXXXXXXXXXXXX---XXXXXXXXXXX--X-||||||||||||||||||||||||||||||||---||||||||||||----|||||||--|||--|||-|-----||||||||||||||||||||||||||||||||
