------------------------------------------------------------------------------------------------------------------------------------------------------
------------------------------------------------------------------------------------------------------------------------------------------------------
------------------------------------------------------------------------------------------------------------------------------------------------------
------------------------------------------------------------------------------------------------------------------------------------------------------
------------------------------------------------------------------------------------------------------------------------------------------------------
------------------------------------------------------------------------------------------------------------------------------------------------------
------------------------------------------------------------------------------------------------------------------------------------------------------
------------------------------------------------------------------------------------------------------------------------------------------------------
-------------------------------------------------------------------------------------------------g--%-%--%------------------------------------------k-
----------------------------------------------------g-----------------------S--------------------------------------SSSC---%%%--------%--gg------------
---------------------------------------gSCCS------gg---------gg----------------ggg%%%%-----------------------------------g||-------------|-%%%%%%%%%%%
-----------------------------------------------||------%%%%%%||--g----%%%%%%------||||gg%%%g%%%%%%%%%%-------g------------||%%%%gggggggg-%%|||||||||||
------------------------------%%%%%%%%---------|-----%%%%||%%%%%%%--%|||||||-----%%%%%||||||||||||||||--%%%%%-------------|||||||||--||--|||||||||||||
--------------------------g---|||||||||%%%%%%%%%%%%-||||||||||||||-||||||||||----|||||||||||||||||||||--|||||----------%%%%%%%%%%|%%%||%%|||||||||||||
------%%%%%-------------------|||||||||||||||||||||-||||||||||||||-||||||||||---||||||||||||||||||||||%%||%|||--------||||||||||||||||||||||||||||||||
XXXXXX|||||XXXXXXXXXXXXXX---XXXXXXXXXXX|||||||||||||||||||||||||||-||||||||||--|||||||||||||||XX||||||||||||||--XXXXXXXXX|||||||||||||||||||||||||||||
