------------------------------------------------------------------------------------------------------------------------------------------------------
------------------------------------------------------------------------------------------------------------------------------------------------------
------------------------------------------------------------------------------------------------------------------------------------------------------
------------------------------------------------------------------------------------------------------------------------------------------------------
------------------------------------------------------------------------------------------------------------------------------------------------------
------------------------------------------------------------------------------------------------------------------------------------------------------
------------------------------------------------------------------------------------------------------------------------------------------------------
------------------------------------------------------------------------------------------------------------------------------------------------------
------------------------------------------------------------------------------------------------------------------------------------------------------
------------------------------------------------------------------------------------------------------------------------------------------------------
-----------------------------------------------------------------------------------------------------------------------------------------------%%%%%%%
---------------------------------------------------------------------------------------------------------------------ggg--------g---g-g--------|||||||
--------------------------------------------------------%%%%%%%%%%-%%%%%%%%%%------%%%%%---|---------%----%%---------------------------------%%%||||||
------------------------------%%%%%%-||---%%%%%%----|---||||-||||--||||||||||%--%%%%%%%%%%%%%%--||--||----||--------%%%%%%%%%%%%%%%%%%%%%-%%||||||||||
------%%%%%--------------------|||||-|----||||||%%--||%%||||-||||%%|||||||||||-|||||||||||||||--||%-%%%%%%%||-------|||||||||||||||||||||-||||||||||||
XXXXXX|||||XXXXXXXXXXXXXX----XXXXXXXXX----||||||||||||||||||-|||||||||||||||||-||||||||||||||--||||||||||||||-------X||||||||||||||||||||-||||||||||||
