------------------------------------------------------------------------------------------------------------------------------------------------------
------------------------------------------------------------------------------------------------------------------------------------------------------
------------------------------------------------------------------------------------------------------------------------------------------------------
------------------------------------------------------------------------------------------------------------------------------------------------------
------------------------------------------------------------------------------------------------------------------------------------------------------
------------------------------------------------------------------------------------------------------------------------------------------------------
------------------------------------------------------------------------------------------------------------------------------------------------------
------------------------------------------------------------------------------------------------------------------------------------------------------
------------------------------------------------------------------------------------------------------------------------------------------------------
------------------------------------------------------------------------------------------------------------------------------------------------------
------------------------------------------------------------------------------------------------------------------------------------------------------
------------------------------------------------------------------------------------------------------------------------------------------------------
---------------------------------------------------------------------------------------------------------------------------%%%-%%-%%%%%%%-%-%%%-%%%---
-------------------------------------------------%%%%%%---%------------------%---%%%%%%%-%%%%%%-%%%%%%%%%%%%%%%%%%%%%%%%%%-|||%||%||||||%%%%|||||||%%%
------%%%%%--------------------------------------||||||%-%|------%%%%%%%%%%|-||----|||||--|||||%%%%%%%||||||||||||||||||||||||||||||||||||||||||||||||
XXXXXX|||||XXXXXXXXXXXXXX-----XXXXXXXXXXXXXXXXXXX||||||--||------||||||||||||||-----||||-|||||||||||||||||||||||||||||||||||||||||||||||||||||||||||||
