------------------------------------------------------------------------------------------------------------------------------------------------------
------------------------------------------------------------------------------------------------------------------------------------------------------
------------------------------------------------------------------------------------------------------------------------------------------------------
------------------------------------------------------------------------------------------------------------------------------------------------------
--------------------------------------------------------------------------------------------------------------------------------------------C---------
-----------------------------------------------------------------------------------------------------------------------------g-k%------S--------------
---------------------------------------------------------------------------------%---------%%----------C--%------------Ck|----------------------------
------------------------------------------------------------------------------------------------------------S%%%-----%----------------------%kggggg-%%
-------------------------------g---T--S-CSC--SCS2-------g--g-----%%%%%%-%---|---------%%%g-|--%%-------------||-|-Uk%-g%%%%%%%%%%---%%%%%Cg--g---|--k|
---------------------------------------------------------------g||g||||||--|gg-%%%%%%---|--|gggggggggggg%%%%g%----g|||||g|||||CCSCkg|||--|U----------|
---------------------------------------------------k---------%%%%|%%%|%%%%%%||%%%|||||-------||||||||||||||||||g------|||||||||||----||---|%%%%%%%%%%%
-------------------------%%%%%%%%%%%%%%%g%%%%%%%%gkggggggggg%%|||||||||||||||||||||||%%%%%%%%g|g||||||g-||--|g|--Sg-CSSSS|-|g-ggggkggggg---|||||||||||
-------------------------||||||||||||||||||||||||----|||||||||||||||||||||||||||||||||||||||--------||---|--|-------------------------------2S||||||||
-------------------------||||||||||||||||||||||||-----||||||||||||||||||||||||||||||||||||||--------||---|--|--------------------------------||-||||||
------%%%%%--------------||||||||||||||||||||||||------|||||||||||||||||||||||||||||||||||||--------||---|--------------------------------------||||||
XXXXXX|||||XXXXXXXXXXXXXX||||||||||||||||||||||||XXXXXXXXXXXXXX|||X||||||||||||||||||||||XXXXXXXXXXXXXXXXXXXXXXXXXXXXXXXXXXXXXXXXXXXXXXXXXXXXXXXXXXXXX
