------------------------------------------------------------------------------------------------------------------------------------------------------
------------------------------------------------------------------------------------------------------------------------------------------------------
------------------------------------------------------------------------------------------------------------------------------------------------------
------------------------------------------------------------------------------------------------------------------------------------------------------
------------------------------------------------------------------------------------------------------------------------------------------------------
------------------------------------------------------------------------------------------------------------------------------------------------------
------------------------------------------------------------------------------------------------------------------------------------------------------
------------------------------------------------------------------------------------------------------------------------------------------------------
------------------------------------------------------------------------------------------------------------------------------------------------------
------------------------------------------------------------------------------------------------------------------------------------------------------
------------------------------------------------------------------------------------------------------------------------------------------------------
---------------------------------------ggkgkkkg----------------%%%%%%%%-----------------------------------------------------------------------------|-
--------------------------g---%%%%%%---------------------------||||||||---%%%%%%%%%%%--------------------------------------------------------------||-
------------------------------||||||--------------------------|||||||||%%%|||||||||||--------------------------------------------------------------||-
------%%%%%--------------------|||||--%%%%%%%-----------------|||||||||||||||||||||||------------------------------------------------------------|-||%
XXXXXX|||||XXXXXXXXXXXXXX---XXXXXXXXXXX|||||---XXXXXXXXXXX--XX||||||||||||||||||||||||--XXXXXXXXXXXXXXXXXXXXXXXXXXXXXXXXXXXXXXXXXXXXXXXXXXXXXX---|-|||
