------------------------------------------------------------------------------------------------------------------------------------------------------
------------------------------------------------------------------------------------------------------------------------------------------------------
------------------------------------------------------------------------------------------------------------------------------------------------------
------------------------------------------------------------------------------------------------------------------------------------------------------
------------------------------------------------------------------------------------------------------------------------------------U-----------------
------------------------------------------------------------------------------------------------%-----------------------------------------------------
-----------------------------------------------------------------------------------C-------------------%---%kSS---%%--2C-------------|-|------------|-
---------------------------------------------------------------------------------------|--------||--|||||-%|--------|%||--%%%%g-%%-||%|---%%%%%%%-r%|-
---------------------------------------------S---%%--%%%--g%g------------%--%%--%--%-%%||-|||-------|-|||--||%%-|||||-|||||||-|||-|||||||F|-|||||-||||
--------------------------g-----------kgggggggk--|||||||-----%%%%%%%%%%%%%|-||--|||||-||||||||%%%%%%||||||%|||-%%%||||||||||||||||||||||||||||||||||||
------------------------------------||||-|||------||||||--|--||||||||||||||-||--||||||||||||||||||||||||||||||||||||||||||||||||||||||||||||||||||||||
-------------------------%%%%%%%%%%-|||-||||||||%||||||gkggkg|k|k--||||||||kggkgk||||||||||||||||||||||||||||||||||||||||||||||||||||||||||||||||-||||
-------------------------|||||||||||||||||||||||||||||||-|||-------||--|||||||--|||||||||||||||||||||||||||||||||||||||||||||||||||||||||||||||||-|--|
-------------------------||||%%%%%%%%%%%||||||||||||||||-|||-|-----||---||||||-%||||||||||||||||||||||||||||||||||||||||||||||||||||||||||-||-|||-|--|
------%%%%%--------------|||||||||||||||||||||||||||||||--||------------||||||-|||||||||||||||||||||||||||||||||||||||||||||||||||||||||||-||--||----|
XXXXXX|||||XXXXXXXXXXXXXX|||||||||||||||||||||||XXX|||XXXXXXXXXXXXXXXXXXXXXXXXXXXXXX|||||||||||||||||||||||||||||XX||||||||||XXXXXXXXXX|XXX|XXXXXXXXXX
