-------------------r--------------------2---------C------|2--kF--|---gST-----------U---------X----------------F---|---------------k--------------S--%-
----U------------------t---2-------------------------------------2-----------------------U---|--------r---------U-U--------------------T--------------
--C---------S-------g----C-X------------------------------------%------r---Uk--C-------------------F-t-|-----------U--------------U---2-------T-----2-
--t----k---------------------------------C------tS-----------------------%--------F---------------------------------------------------X------%--------
-------S-------------------------------------------------|------------------------Sg------%U----2------C----------X--X--------T-----r-%----g--------T-
------------T------------U-----------------------2------C-C------U-------------------------------------------------|-------------T---------------g----
-g---------%-k------------------------C--------------------------r------r-------------g--------|--F---2---------------%--k-----------t----------2-----
--%----------U------------T------------T------rU-----2-----------------------S---------------------------------------F---|----------------------------
-%-----------g---2%--%-----g------T------k--------------------------k-------g-------C----C---------------------|-C------S%X-|--%C---------------------
----------------------|-----------2----|-r---------------------X---g------------C--r-2-------------------------------------F--F---2-----gk-----------2
||--------gr----X-----|---g--------g------------------|U----------%-----g------------CXT--%--------%-------Cg-------------r%----|-----------------C---
--------S-----g-------------------k-----|------%-%-%---t------g-|%kk--|-%----C----k------|-g-|gt--|----F-------%-------------------------------X------
-----r--------------Fk-------------|--------2---------T--2------------k------T----%--T---r--|---|-|%%F---k---|--U--------X-kt-----U--U---%-----%------
---------|-%-%----F--%-%-%r------------------------------%--U--------------------S-------%--------F------Fgg---|g-F%-----|-------------U---%--%F%--%--
--||-|---%t---%k%-||---%%|tk|S|----%%t-X%%----%%|%-%-%|---%%k--k||%%%--%-----%-%%%-%%---%%--------------------------------------t----g--------g-g-----
-%|-T-|g----%----%kU--2|--|---%%-||%--k-|---|-%--|-|g|--|--||-||-rS--%|%%|%-|||-T-r-||k---||t-%%%|2---%---|%||-|-|--%C-T-|-%||%%r--|---%-2--|%--|2|---
