------------------------------------------------------------------------------------------------------------------------------------------------------
------------------------------------------------------------------------------------------------------------------------------------------------------
------------------------------------------------------------------------------------------------------------------------------------------------------
------------------------------------------------------------------------------------------------------------------------------------------------------
------------------------------------------------------------------------------------------------------------------------------------------------------
------------------------------------------------------------------------------------------------------------------------------------------------------
------------------------------------------------------------------------------------------------------------------------------------------------------
------------------------------------------------------------------------------------------------------------------------------------------------------
------------------------------------------------------------------------------------------------------------------------------------------------------
--------------------------------------------------------g---------------------------------------------------------------------------------------------
-----------------------------------------------------------g---------------------------%gggg%%%---------%%--%%--------g-g-|---|--|%--%%%%%%%%%%------|
------------------------------------------------|%---%%%|--||ggg-------g--------------gg||-|||||%%%%%%%%||--||---k-------||-%%%%%||||||||||||||%%%--%%
---------------------------------------------%--|||||||||--|||--------------------------%%-|||||||||||||||--|%%%%|------||||||||||||||||||||||||||--||
--------------------------g----|%--%%--%%%-%||%||||||||||%%%%%%%%----%%%%--------------|||||||||||%%%%%|||||||||||-----|||||||||||||||||||||||||||--||
------%%%%%-------------------|||--||--||-||||||||||||||||||||||------|||------------%%||||||||||||||||||||||||%|%%%%%%|||||||||||||||||||||||||||-|||
XXXXXX|||||XXXXXXXXXXXXXX---XXXXXXXXXXXXXXX|||||||||||||||||||||XXXXXXXXXXX--XXXXXXXX|||||||||||||||||||||||||||||||||||||||||||||||||||||||||||||||||
