------------------------------------------------------------------------------------------------------------------------------------------------------
------------------------------------------------------------------------------------------------------------------------------------------------------
------------------------------------------------------------------------------------------------------------------------------------------------------
------------------------------------------------------------------------------------------------------------------------------------------------------
-----------------------------------------------------------------------------------------%--------C---------%g--------------%---%------%----CCSSSS--%%
--------------------------------------------------------------%--g%--------------------%%%S%--S----------%-------C%---------gg%k%------S|Sg-----------
---------------------------------------------------------------------------------%%C%%--|-||%-------%%|||%%%%|S----%%-2Ck||------|--%|-|--------------
---------------------------------------------------------------------------------|||-S-|---------|--||||||||S|%%%---%%%|-||||%g-%%%%|%|-%-%%%%%%%%%%%%
-------------------------------gSCUT-CS-CSC--SCS22%S%SCSSSSgg----2-|%%%%%%%%%%%%%--|-%%%%%%||%%|%--||-||||-||||-|||||-||||%%%%%%%-|||||||F|-||||||||||
--------------------------g------------gggggggkg-|||||||-----%%%%%g%|||||||||||||%%%%-||||||||||%%%%%%%%%%%%||-|||||||||||||||||||||||||||||||||||||||
----------r---------------------------||g|||-------||||------|||||||||||||||||||||||||||||||||||||||||||||||||||||||||||||||||||||||||||||||||||||||-%
-------------------------%%%%%%%%%%%%%%%|%%%%%%%%%%%|||gkggggk||||||||||||||||||||||||||||||||||||||||||||||||||||||||||||||||||||||||||||||||||||||||
-------------------------||||||||||||||||||||||||||||||||||||||||||||||||||||||||||||||||||||||||||||||||||||||||||||||||||||||||||||||||--|2S|||-----
-------------------------|||||||||||||||||||||||||||||||||||||||||-||||||||||||||||||||||||||||||||||||||||||||||||||||||||||||||||||||||--||-||------
------%%%%%--------------||||||||||||||||||||||||||||||||||||||||--|||||||||||||||||||||||||||||-|||||||||||||||||||||||||||--|||--|--|||--||---------
XXXXXX|||||XXXXXXXXXXXXXX|||||||||||||||||||||||XXXXXXXXXXXXXXXXXXXXXXXXXXXXXXXXXXXX||||||XXXXXXXXXXXXXXXXXXXXXXXXXXXXXXXXXXXXXXXXXXXXXXXXXXXXXXXXXXXX
