------------------------------------------------------------------------------------------------------------------------------------------------------
------------------------------------------------------------------------------------------------------------------------------------------------------
------------------------------------------------------------------------------------------------------------------------------------------------------
------------------------------------------------------------------------------------------------------------------------------------------------------
------------------------------------------------------------------------------------------------------------------------------------------------------
------------------------------------------------------------------------------------------------------------------------------------------------------
------------------------------------------------------------------------------------------------------------------------------------------------------
------------------------------------------------------------------------------------------------------------------------------------------------------
------------------------------------------------------------------U------------------------------------------------------------------U----------------
---------------------------------------------------------------------------------------------------------S-----------------CS---S---------------------
----------------------------------------------------------------------------%%%%%------------------------------------------------------------%%%%%%%%%
---------------------------------------ggkgkkkgkk-------%%---%%%%%%%%%%%%%%%%|-|||-------ggg-g---g-------------------------------------------|||||||||
-----------------------------%%%%%%%%%------------------|||--|||||||||||||||%%%%%%%%%%%%--------------------------------------------------------||||||
--------------------------gg-|||||||||------------------||---|||||||||||||||||||||||||||-----------------------------------------------------|--||||||
------%%%%%-------------------|||||||-%%%%%%%%S---------||--%||||||||||||||||||||||||||------------------------------------------------------|||||||||
XXXXXX|||||XXXXXXXXXXXXXX---XXXXXXXXXX|||||||||||XXXXXXXX|X-|||||||||||||||||||||||||||||XXXXXXXXXXXXXXXXXXXXXXXXXXXXXXXXXXXXXXXXXXXXXXXXXXXXXXX||||||
