------------------------------------------------------------------------------------------------------------------------------------------------------
------------------------------------------------------------------------------------------------------------------------------------------------------
------------------------------------------------------------------------------------------------------------------------------------------------------
------------------------------------------------------------------------------------------------------------------------------------------------------
------------------------------------------------------------------------------------------------------------------------------------------------------
------------------------------------------------------------------------------------------------------------------------------------------------------
------------------------------------------------------------------------------------------------------------------------------------------------------
------------------------------------------------------------------------------------------------------------------------------------------------------
------------------------------------------------------------------------------------------------------------------------------------------------g---%-
----------------------------------------------%--%-%%%----%---g--------------------g---g---%%%%%%%---|||-------%%%--%%-------------%%-%%-%%%%%%%%-%g|-
--------------------------------------k------------|||----|--------C-gggg-----------%%------|--||||%%||%--||-g|||--|||||%%%|%%%%%%%|||||||||||||||||||
----------------------------------------------||---||||---|k---------------kgg----g||||%%%%%%%%|||||||||||||%%%%%-%|||||||||||||||||||||||||||||||||||
-------------------------------------------|--||%%%%%%%%%%%%%%---------%%%--------|||||||||||||||||||||||||||||||-|||||||||||||||||||||||||||||||%%%%|
-------------------------%%%%%%%%%%%%%%%%%%%%%||||||||||||||||---------|||-|-----%%||||||||||||||||||||||||||||||-||||||||||||||||||||||||||||||||||||
------%%%%%--------------|||||||||||||||||||||||||||||||||||------------|%%|-----||||||||||||||||||||||||||||||||-||||||||||||||||||||||||||||||||||||
XXXXXX|||||XXXXXXXXXXXXXX|||||||||||||||||||||||||||||||||||--XX-XXXXXXX|XXXXXXXXX|||||||||||||||||||||||||||||||-||||||||||||||||||||||||||||||||||||
