------------------------------------------------------------------------------------------------------------------------------------------------------
------------------------------------------------------------------------------------------------------------------------------------------------------
------------------------------------------------------------------------------------------------------------------------------------------------------
------------------------------------------------------------------------------------------------------------------------------------------------------
------------------------------------------------------------------------------------------------------------------------------------------------------
------------------------------------------------------------------------------------------------------------------------------------------------------
--------------------------------------------------------------------------------------------%-------------------------2--------------|----------------
------------------------------------------------------------------------------------------------------------------------------------------%%%g-||g----
---------------------------------------------------------------------------------------%|--||---------||-----------|--|---ggg--||--|--|---|-|||||--|||
-------------------------------------------------|--|g-------%%%%--%%%%%%%--gg---||g|-|||-|||g%%%%%%|||||%%%%%-%%%g||||gg||||||||-k|||||-||||||||--|||
--------------------------------------|--k-k------|||||---|--||||--||||||||-||---|||%|||-||||||||||||||||||||||||||||||||||||||||||||||||||||||||||||%
-------------------------%%%%%--%%---||-k||||-||%||||gkgkggk-||||--||||||||k|gkCk||||||%%%%%|||||||||||||||||||||S|||||||||||||||||||||||--|||||||||||
-------------------------|||||||||||-||-||||||||||||||||||||-|||---|||||||||||--|||||||||||||||||||||||||||||||||-|||||||||||||||||||||||--|||||||||||
-------------------------||||||%|%%%%%|%%|||||||||||||||||||-|||---|||||||||||-%||||||||||||||||||||||||||||||||--|||||||||||||||||||||||--|||||||||||
------%%%%%--------------|||||||||||||||||||||||||||||||||||||-----|||||||||||-||||||||||||||||||||||||||||||||||--||||||||||||||||||||||--|||||||||||
XXXXXX|||||XXXXXXXXXXXXXX|||||||||||||||||||||||||X||||XXXXXXXXXXXXXXXXXXXXXXXXXX||||||||||||||XXXXX|||||||||||XXXXXX|||||X||XXXXXXXXXX|XXX||XX|XXXXXX
