------------------------------------------------------------------------------------------------------------------------------------------------------
------------------------------------------------------------------------------------------------------------------------------------------------------
------------------------------------------------------------------------------------------------------------------------------------------------------
------------------------------------------------------------------------------------------------------------------------------------------------------
------------------------------------------------------------------------------------------------------------------------------------------------------
------------------------------------------------------------------------------------------------------------------------------------------------------
------------------------------------------------------------------------------------------------------------------------------------------------------
------------------------------------------------------------------------------------------------------------------------------------------------------
------------------------------------------------------------------------------------------------------------------------------------------------------
------------------------------------------------------------------------------------------------------------------------------------------------------
------------------------------------------------------------------------------------------------------------------------------------------------------
------------------------------------------------------------------------------------------------------------------------------------------------------
-------------------------------------------------------------------------------------------------------------------------%%-%%%%%%%%%%%%%-%2----------
-----------------------------------------------%%%%%%%%%%%%%%%%%%%%---%----------------------%%%%%%%%%%%%%%%%%%%%%%%%-----|-||||||||||||||||%%%%%%%%%%
------%%%%%-------------------------------------||||||||||-||--|||||--||-----%%%------------%|||||||||||||||||||||||||%%%%%%%|%%||||||||||||||||||||||
XXXXXX|||||XXXXXXXXXXXXXX-----XXXXXXXXXXXXXX-XXX||||||||||-||--|||||--||-----|||-------X----||||||||||||||||||||||||||||||||||||||||||||||||||||||||||
