------------------------------------------------------------------------------------------------------------------------------------------------------
------------------------------------------------------------------------------------------------------------------------------------------------------
------------------------------------------------------------------------------------------------------------------------------------------------------
------------------------------------------------------------------------------------------------------------------------------------------------------
------------------------------------------------------------------------------------------------------------------------------------------------------
------------------------------------------------------------------------------------------------------------------------------------------------------
------------------------------------------------------------------------------------------------------------------------------------------------------
------------------------------------------------------------------------------------------------------------------------------------------------------
------------------------------------------------------------------------------------------------------------------------------------------------------
------------------------------------------------------------------------------------------------------------------------------------------------------
------------------------------------------------------------------------------------------------------------------------------------------------------
------------------------------------------------------------------------------------------------------------------------------------------------------
---------------------------------------------------------------------------------------------------------------------------%%%-%%%%%%%%%%-%2%%%%%%%%-k
-------------------------------------------------%%%%%%%%%%%-----------------%----%%%%%%%%%%%%%%%%%%%%%%%%%%%%%%%%%%%%%%%%%|||%%%%%||||||%|||||||||%%%
------%%%%%------------------------------------|-||||||%|%||-----%%%%%%%%%%|-%-----|||||||||||||||||||||||||||||||||||||||||||||||||||||||||||||||||||
XXXXXX|||||XXXXXXXXXXXXXX-----XXXXXXXXXXXXXXXXXX||||||||||||-----||||||||||||||----|||||||||||||||||||||||||||||||||||||||||||||||||||||||||||||||||||
