------------------------------------------------------------------------------------------------------------------------------------------------------
------------------------------------------------------------------------------------------------------------------------------------------------------
------------------------------------------------------------------------------------------------------------------------------------------------------
------------------------------------------------------------------------------------------------------------------------------------------------------
------------------------------------------------------------------------------------2------S---------------------CS-------%---------U-----------------
--------------------------------------------------------------------------------U---------------------------------------------------------------------
--------------------------------------------------------------------%--%----%CUU-----%--%---k--%------------------S--C2--------SSSCSSk-gS%%%%CS%----|-
-------------------------------2--S-SCC------------------%-----------------------%%-|-----------%%C-%%%%-%%%----S-----------g%--|---------|||||||-----
---------------------------------------------------------%----%-g------------------|-|-||------||||||-||||-gg-------------||--g-------------||||%%%%%%
---------------------------------------%%%%%%%%%%%%%%%%%%%%%%%g%g--g%g%%%%%%S----||g---g|-%%%%%%|||||||||||||--%%r%%%%%%%%%%%%%%%%%%%%%%%%%%%%||||||||
--------------------------------r---kgkgggggg-----||||||--||-|||---C-|||||||----g%%%%%%%%%%||||||||||||||||||g|g||||||||||||||||||||||||||||||||||||||
------------------------------------||||||||||||||||||||||||||||-----||||||kggkgk||||||||||||||||||||||||||||||||S-|||||||||||||||||||||||||||||||||||
----------------------------------------||||||||||||||||||||||||------|||||-------|||||||||||||||||||||||||||||||--|||||||||||||||||||||||||||||||||||
-------------------------%%%%%%%%%%%%%%%%%%%%|||||||||||||||||||------||||--------|||||||||||||||||||||||||||||||--|||||||||||||||||||||||||||||||||||
------%%%%%--------------|||||||||||||||||||||||||||||||||||||||-------|||--------|||||||||||||||||||||||||||||||--|||||||||||||||||||||||||||||||||||
XXXXXX|||||XXXXXXXXXXXXXX||||||||||||||||||||||||||||||||||||||XXXXXXXXXXXXXXXXXXXX||||||||||||||||||||||||||||||-X|||||||||||||||||||||||||||||||||||
