------------------------------------------------------------------------------------------------------------------------------------------------------
------------------------------------------------------------------------------------------------------------------------------------------------------
------------------------------------------------------------------------------------------------------------------------------------------------------
------------------------------------------------------------------------------------------------------------------------------------------------------
------------------------------------------------------------------------------------------------------------------------------------------------------
------------------------------------------------------------------------------------------------------------------------------------------------------
------------------------------------------------------------------------------------------------------------------------------------------------------
------------------------------------------------------------------------------------------------------------------------------------------------------
------------------------------------------------------------------------------------------------------------------------------------------------------
------------------------------------------------------------------------------------------------------------------------------------------------------
----------------------------------g----------------------k--------------------------------------------------------------------------------------------
-------------------------------------g----------------------------------------------------------------------------------------------------------------
----------------------------------------------------------------%%%%%%------%%%%%%--------------------------------------------------------------------
---------------------------------%------------------------------||||||%--%%%|||||%%%%----------------------------%%%------------------------------%%--
------%%%%%----------------------------------------------------||||||||-|||||||||||||----------------------------|||------------------------------||--
XXXXXX|||||XXXXXXXXXXXXXX---XXXXXXXXXX--------XXXXXXXXXXX----X-||||||||--||||||||||||---XXXXXX--X---XXX--XXXXXXXX||-------XX----------------------||--
