------------------------------------------------------------------------------------------------------------------------------------------------------
------------------------------------------------------------------------------------------------------------------------------------------------------
------------------------------------------------------------------------------------------------------------------------------------------------------
------------------------------------------------------------------------------------------------------------------------------------------------------
------------------------------------------------------------------------------------------------------------------------------------------------------
------------------------------------------------------------------------------------------------------------------------------------------------------
------------------------------------------------------------------------------------------------------------------------------------------------------
------------------------------------------------------------------------------------------------------------------------------------------------------
--------------------------------------------------------------------------------------------------------------------------g---------------------------
-----------------------------------------------------------------------------------g-----------%%%-----------%----------------------------U---------g-
---------------------------------------------------------------gg---%g-g%g---------------------------||--------------------------------------------%--
--------------------------------------k----g--kg---------------------------kg%---%%%%%%---%%--------||----%%%%%%--%%|%g%g--|g-ggg-kgg-gg----------||--
--------------------------------------|-----------%%%%----%-------%%%%%%%%%%||---||||||||||||----|--|%%%%-||||||--|||||||--||--||--||----------%%%%%%-
-------------------------%%%%%%%%%%%-%|--||%-------||-----|--------|||--||||||%%%%||||||||||||--||--||||-||||-||--|||||||--||--||--||--%-------|||||||
------%%%%%--------------|||||||||||-||--||||-||----|-----|--------||%--|%||||||||||||||||||||---%--||||-||||-||--|||||||--||--||--||--|-------||||||-
XXXXXX|||||XXXXXXXXXXXXXX||||||||||||||||-|XXXXXXXX||--XXXXX-XXXXXX||||||||||||||||||||||X|||---X|XX|||||||||-||--|||||||--||-XXXXX|XXX|X--||-X|||||XX
