------------------------------------------------------------------------------------------------------------------------------------------------------
------------------------------------------------------------------------------------------------------------------------------------------------------
------------------------------------------------------------------------------------------------------------------------------------------------------
------------------------------------------------------------------------------------------------------------------------------------------------------
------------------------------------------------------------------------------------------------------------------------------------------------------
------------------------------------------------------------------------------------------------------------------------------------------------------
------------------------------------------------------------------------------------------------------------------------------------------------------
------------------------------------------------------------------------------------------------------------------------------------------------------
--------------------------------------------------------------------------------------------------------------------------r---------------------------
----------------------------------------------------------------------------------g----------g---g--Sggg---S%S---------------------g------U---------g-
---------------------------------------------------------------gg%%%%%%%%%%--------------------------|--------------------------------------------%%--
---------------------------------%---%k-kgkgkgggg--gg------------||||||--||k%%%-%%%%%%%%%%%-------------------%---||ggggg---g--gg---g-g-----------||--
----------------------------%%---||--||--|||-------------------%%%%%%%%%%%%||||||||||||||-|-----------------------|||||-------------------------%-%|--
-------------------------|||||%%|||%-||--|||--------------|-----|||||||-|||||||||||||||||-||---------|----||------|||||---------------------------||--
------%%%%%--------------|||||||||||-||%%%|||-|-----------|-----|||||||-|||||||||||||||||-||---------|-----|------|||||---------------------------||--
XXXXXX|||||XXXXXXXXXXXXXX||||||||||||||||||XXXXXXXXXXXXXXXXXXXXX||||||||||||||||||||||||XXXXXXXXXXXXXXXXXXXXXXXXXXXXXXXXXXXXXXXXXXXXXXXXXXXXXXXXXX|XXX
