-------------------r--------------------2---------C------22--kF--|---gST-----------U---------X----------------F---|---------------k--------------S--%-
----U------------------t---2-------------------------------------2-----------------------U---|--------r---------U-U--------------------T--------------
--C---------S-------g----C-X------------------------------------%------r---Uk--C-------------------F-t-|-----------U--------------U---2-------T-----2-
--t----F---------------------------------C------tS-----------------------%--------F---------------------------------------------------X------%--------
-------S-------------------------------------------------|------------------------Sg------%U----2------C----------X--X--------T-----r-%----g--------T-
------------T------------U-----------------------2------C-C------U-------------------------------------------------|-------------T---------------g----
-g---------%-k------------------------T--------------------------r------r-------------g--------|--F---2---------------%--k-----------t----------2-----
--%----------U------------T------------T------rU-----2-----------------------S---------------------------------------F---|----------------------------
-%-----------g---2%--%-----g------T------k--------------------------k-------g-------k----C---------------------|-C------F%X-|--%C---------------------
----------------------|----------t2----|-r---------------------X---g------------C--rU2-------------------------------------F--F---2-----gk-----------2
||--------gr----X-----|---g--------g------------------|U----------%-----g------------CXT--%--------%-------C--------------r%----|-----------------C---
--------S-----g-------------------k-----|------%-%-%---t------g-|%k---|-%----C----k------|-g-|gt--|----F-------%-------------------------------X------
-----r--------------Uk-------------|--------2---------T--2------------k------T----%--T---r--|---|-|%%F---k---|--U--------X-kt-----X--U---%-----%------
--|------|-%-%----F--%-%-%r------------------------------%--U--------------------S-------%--------F------Fgg---|g-F%-----|-------------U---%--%F%--%--
--||-|%--%t---%k%-%|---%%|tk|S|----%%t-X%%----%%|%-%-%|---%%k--k|-S%%--%-----%-%%%-%%---%%--------------------------------------t----g--------g-g-----
-%|-T-|g----%----kkU--2|--|---%%-||%--k-|---|-%--|-|g|--|--||-||-rS--%|%%|%-|||-T-r-||%---||t-%%%|2---%---|%||-|-|--%C-T-|-%||%%r--|---%-2--|---|2|---
