	------------------------------------------------------------------------------------------------------------------------------------------------------
------------------------------------------------------------------------------------------------------------------------------------------------------
------------------------------------------------------------------------------------------------------------------------------------------------------
------------------------------------------------------------------------------------------------------------------------------------------------------
------------------------------------------------------------------------------------------------------------------------------------------------------
------------------------------------------------------------------------------------------------------------------------------------------------------
------------------------------------------------------------------------------------------------------------------------------------------------------
-------------------------------------------------------------------------------------------------------------------------------------------g----------
------------------------------------------------------------------------------------------------------------------------------------------------g-----
--------------------------------------U-------%---------------g------------------------gg-S%%------------------%%%-------------------------%%%%%---g--
-------------------------------------------------------------------C-gggg----------------------ggg%%%%%%--%---|||--|||%%%%%%%%%%%%%%%%||---||||||--|--
---------------------------------------------------------------------------kggg---gg--%---%%%%-|||||||||%%%%%%%%%%%%|||||||||||||||||||||------|------
----------------------------------------------%%%%%%%%%%--%%-------------------------||||%%|||||||||||||||||||||||||||||||||||||||||||||||%2%%%%%%%%%k
-------------------------%%%%%%%%%%%%%%%%%||%||||||||||---||-----------------%---%%%%|||||||||||||||||||||||||||||||||||||||||||||||||||||||||||||||||
------%%%%%--------------||||||||||||||-|||||||||||||||---||------------%%%--|---|||||||||||||||||||||||||||||||||||||||||||||||||||||||||||||||||||||
XXXXXX|||||XXXXXXXXXXXXXX|||||||||||X||XXXXXXXXXX||||||---||--XXXXXXXXXXXXXXXXXXXXXX||||||||||||||||||||||||||||||||||||||||||||||||||||||||||||||||||
