------------------------------------------------------------------------------------------------------------------------------------------------------
------------------------------------------------------------------------------------------------------------------------------------------------------
------------------------------------------------------------------------------------------------------------------------------------------------------
------------------------------------------------------------------------------------------------------------------------------------------------------
------------------------------------------------------------------------------------------------------------------------------------------------------
------------------------------------------------------------------------------------------------------------------------------------------------------
------------------------------------------------------------------------------------------------------------------------------------------------------
------------------------------------------------------------------------------------------------------------------------------------------------------
------------------------------------------------------------------------------------------------------------------------------------------------------
------------------------------------------------------------------------------------------------------------------------------------------------------
--------------------------------------------------------------------------------------------g---------------%%-%%%------------%--%%-%%%%%%%%----------
-----------------------------------g-------------%%%----------g----------------------------------------%|%--||-||||%------|---|--||--|-|||||----------
--------------------------------------------%%---|||----------------------------------------%-%%%-||---|||--||||||||%%%%F%|--%%%%%%%%%%|||||----------
--------------------------------------------||--|||%%%%-----%-----%-------------------------|||||||%%%%%%%%%||||||||||||||||-|||||||||||||||----------
------%%%%%--------------------%%------------|--|||||||-----|-------------------------------||||||||||||||||||||||||%%%%%%%%%|||||||||||||||%%%%-----%
XXXXXX|||||XXXXXXXXXXXXXX---XX|||XXXXXXXXXXXXXXXXX||||||---XXXXXXXXXXXXXXXXXXXXXXXXXXXXXXX-|||||||||||||||||||||||||||||||||||||||||||||||||||||||---|
