------------------------------------------------------------------------------------------------------------------------------------------------------
------------------------------------------------------------------------------------------------------------------------------------------------------
------------------------------------------------------------------------------------------------------------------------------------------------------
------------------------------------------------------------------------------------------------------------------------------------------------------
------------------------------------------------------------------------------------------------------------------------------------------------------
------------------------------------------------------------------------------------------------------------------------------------------------------
------------------------------------------------------------------------------------------------------------------------------------------------------
------------------------------------------------------------------------------------------------------------------------------------------------------
------------------------------------------------------------------------------------------------------------------------------------------------------
------------------------------------------------------------------------------------------------------------------------------------------------------
------------------------------------------------------------------------------------------------------------------------------------------------------
-------------------------------------------------------------------------------------------------------------------------------------------------%--%%
-----------------------------------------------------------------------------------------------------------------------------------------------||--|||
-----------------------------------------------%%%%%%%%%%%%%%%%%%%%%%%%%%%%-------------%----%%%%%%%%%-%%----------------%%%%%%-%%%-%%%%%%%%%%%%||||||
------%%%%%------------------------------------||||||||||||||||||||||||||||--%%%%%%%%-%-|----|||||||||||||--%%%%%%%%%%%%||||||||||||||||||||||||||||||
XXXXXX|||||XXXXXXXXXXXXXX----XXXXXXXXXXXXXX--||||||||||||||||||||||||||||||--|||||||||||||---|||||||||||||||||||||||||||||||||||||||||||||||||||||||||
