------------------------------------------------------------------------------------------------------------------------------------------------------
------------------------------------------------------------------------------------------------------------------------------------------------------
------------------------------------------------------------------------------------------------------------------------------------------------------
------------------------------------------------------------------------------------------------------------------------------------------------------
------------------------------------------------------------------------------------------------------------------------------------------------------
------------------------------------------------------------------------------------------------------------------------------------------------------
------------------------------------------------------------------------------------------------------------------------------------------------------
------------------------------------------------------------------------------------------------------------------------------------------------------
------------------------------------------------------------------------------------------------------------------------------------------------------
------------------------------------------------------------g-----------------------------------------------------------------------------------------
------------------------------------------------------------------------------------------------------------------------------------------------%%--%%
-------------------------------------------------------------------------------------------gg---%%-%%-----------------------%%%%%%%%%%%%%%%%%%%%%%%%%%
------------------------------------------------------%%%%-%%%%---------------------------------|-------%%-%%----------------||||||-||-|||||||||||||||
-------------------------------%%--%%------%%%%%%%%%%%||||||||||%--%%%%%%%%---------%%%%%%%%%%%%%%%%%%--||--|---------%%%%%%%%%%%%%%%%%%||||||||||||||
------%%%%%---------------------|--||------|||||||||||||||||||||||-||||||||------%%%||||||||||||||||||||||%|%%%------%||||||||||||||||||||||||||||||||
XXXXXX|||||XXXXXXXXXXXXXX----XXXXXXXXXXX-X||||||||||||||||||||||||-||||||||-----|||||||||||||||||||||||||||||||-----||||||||||||||||||||||||||||||||||
