------------------------------------------------------------------------------------------------------------------------------------------------------
------------------------------------------------------------------------------------------------------------------------------------------------------
------------------------------------------------------------------------------------------------------------------------------------------------------
------------------------------------------------------------------------------------------------------------------------------------------------------
------------------------------------------------------------------------------------------------------------------------------------------------------
------------------------------------------------------------------------------------------------------------------------------------------------------
------------------------------------------------------------------------------------------------------------------------------------------------------
------------------------------------------------------------------------------------------------------------------------------------------------------
------------------------------------------------------------------------------------------------------------------------------------------------------
--------------------------------------------------------------------------------------------------------------------------------------------g---S-----
------------------------------------------------------------------------------------------------------------------------------------------------------
--------------------------------------------------------------------------------------------------------%%%-----------------%%%%%%%%%%%%%%%%%%%%------
-----------------------------------------------%%%%%%%---------------------------------------%%%%%%%%%%%%%%%%%%%%|%-%%%%F%%%||||||||||||||||||%%%%%%%k
----------------------------------------------%%|||||%%%%%%%%------------------------%%%%%%%%|||||||||||||||||||||||||||||||||||||||||||||||||||||||||
------%%%%%----------------------------------|||||||||||||||||---------%%------------|||||||||||||||||||||||||||||||||||||||||||||||||||||||||||||||||
XXXXXX|||||XXXXXXXXXXXXXX-----XXXXXXXXXXXXXXXX||||||||||||||||-------XX||-------XXXXX|||||||||||||||||||||||||||||||||||||||||||||||||||||||||||||||||
