------------------------------------------------------------------------------------------------------------------------------------------------------
------------------------------------------------------------------------------------------------------------------------------------------------------
------------------------------------------------------------------------------------------------------------------------------------------------------
------------------------------------------------------------------------------------------------------------------------------------------------------
------------------------------------------------------------------------------------------------------------------------------------------------------
------------------------------------------------------------------------------------------------------------------------------------------------------
------------------------------------------------------------------------------------------------------------------------------------------------------
------------------------------------------------------------------------------------------------------------------------------------------------------
------------------------------------------------------------------------------------------------------------------------------------------------------
------------------------------------------------------------------------------------------------------------------------------------------------------
----------------------------------g-------------------------------------------------------------------------------------------------------------------
-------------------------------------gggggg--g--------------------------------------------------------------------------------------------------------
--------------------------------%%------------------------------%%%%%%-----%%%%%%%%-------------------------------------------------------------------
--------------------------------||------------------------------|||||||--%%||||||||%-----------------------------%%%----------------------------------
------%%%%%---------------------||------------------------------|||||||--||||||||||||----------------------------|||----------------------------------
XXXXXX|||||XXXXXXXXXXXXXX---XXXXXXXXXX-XX--X--XXXXXXXXXXXXXXXXX||||||||--||||||||||||-XXXXXXXXXXXXXXXXXXXXXXXXXXX||X-----XXXXXXX--XX---XXXXXX---------
