------------------------------------------------------------------------------------------------------------------------------------------------------
------------------------------------------------------------------------------------------------------------------------------------------------------
------------------------------------------------------------------------------------------------------------------------------------------------------
------------------------------------------------------------------------------------------------------------------------------------------------------
------------------------------------------------------------------------------------------------------------------------------------------------------
------------------------------------------------------------------------------------------------------------------------------------------------------
------------------------------------------------------------------------------------------------------------------------------------------------------
--------------------------------------------------------------------------------------------------------------------|--g-%---%g---%--%%-r-------------
----------------------------------------------------------g--g---------%--gSg--%%----%---%%--%--------------%%--g|--|---||--|%|||-|||--||---%%gg---g--
--------------------------------------ggggggggk------------------g%%-----------||---|-g-gg-g-------%------------|||-----||---|||-|||-------|-||-------
-----------------------------------------------------------%-----||-------------------|||||%%%g%%%%%%%%%%%%%%%%%%%%%%%%%%%%%%%%%%%%%%%%%%%%%%%--------
------------------------------%%%%%gkk--|-g-g%%%%%%%%%%kk-kkgggkgkgkgggggkkgkgkgggkggg-|||||||||-||||||||||||||||||||||||||||||||||||||||||||---------
------------------------------||||-||--%%%%|%%%||||||||-----------------------|||------|||||||||-|||||||||||||||||||||||||||-||||||||||||||||---------
-------------------------%%%%%|||---%--||||||||||||||||-----------------------||--------||||||||-|||||||||||||||||||||||||||-||||||||||||||||---------
------%%%%%--------------||||||||Xk%|--||||||||||||||||------------------------|--------||||||||-||||||||||||||||||||||||||--||||||||||||||||---------
XXXXXX|||||XXXXXXXXXXXXXX|||||||||||||XXXXXXXXXXXXXXXXXXXXXXXXXXXXXXXXXXXXXXXXXXXXXXXXXXXXXX||||-X||XXX|||XX|||||||||||||||--|||X|XXXXX|||||XXXXXXXXXX
