------------------------------------------------------------------------------------------------------------------------------------------------------
------------------------------------------------------------------------------------------------------------------------------------------------------
------------------------------------------------------------------------------------------------------------------------------------------------------
------------------------------------------------------------------------------------------------------------------------------------------------------
------------------------------------------------------------------------------------------------------------------------------------------------------
------------------------------------------------------------------------------------------------------------------------------------------------------
------------------------------------------------------------------------------------------------------------------------------------------------------
------------------------------------------------------------------------------------------------------------------------------------------------------
------------------------------------------------------------------U------------------------------------------------------------------U---C------------
----------------------------------------------------------------------------------------------g-----g----Sgk-------------g-CSSCCSCS-------------------
------------------------------------------k---------------------------------%%%%%%-----------------------------------------------------------%%%%%%%%%
---------------------------------------ggkgkkkgkk-----g%%%%%%%%%%%%%%%%%%%%%|||||||-%%ggggggggggggggg--------g-------------------------------|||||||||
--------------------------%-%%%%%%%%%%-----------------||||-|||||||||||||||||%%%%%%%%%|||----------------------------------------------------|||||||||
--------------------------|g||||||||||--------%%-------||||-|||||||||||||||||||||||||||||----------------------------------------------------||-||||||
------%%%%%-------------------||||||||%%%%%%%%S||------|||--%||||||||||||||||||||||||||||----------------------------------------------------|||||||||
XXXXXX|||||XXXXXXXXXXXXXX---XXXXXXXXXX|||||||||||XXXXXXXXXXX|||||||||||||||||||||||||||||XXXXXXXXXXXXXXXXXXXXXXXXXXXXXXXXXXXXXXXXXXXXXXXXXXXXXXX||||||
