------------------------------------------------------------------------------------------------------------------------------------------------------
------------------------------------------------------------------------------------------------------------------------------------------------------
------------------------------------------------------------------------------------------------------------------------------------------------------
------------------------------------------------------------------------------------------------------------------------------------------------------
-----------------------------------------------------------------------------------------%%-------C------------S%CS-------%-%S22----U%------C---------
-------------------------------------------------------------------------------%U--------%S--%S----2----%%--------------------------------------------
--------------------------------------------------------------------%%-%-------------%--%gggk|||---------|-----------%2C-||-----S|SkS|-|%|%|-%%-------
-------------------------------2-------------------------%-----------------------%%||||---------|||-|%-|||%%S%S%S----||--|||%%---||||---|-|---||-%%---
----------------------------------U------------S--%||%%%%%S---%|gU-|---%%--%--%%%----||||||---%||||||-||||-|g|--|||||---g|||g%g---%-%%%%%%%-%%|%%%||%%
------------------------------|--------%%-gg%%-gg%g|||ggg|--%%|||--||%%||%%%g||||||%|-|-||--g%||||||||||||||||--||||S%%%%%%%%%%%%||%||||||||||||||||||
--------------------------------r---kgkggg%%g-----||||||--|k-||||---|||||||||-||%%%%%%%%%%%%%%%||||||||||||||g%g||||||||||||||||||||||||||||%%%%%|||||
-------------------------%%%%%%%%%%%|-||||||||%%%|||||||%%%||||gkgggggg|||||kgkC|||||||||||||||||||||||||||||||||Sg|||||||||||||||||||||||||||||||||||
-------------------------|||||||||||||-|||||||||||||||||||||||||||--|||||||-----|||||||||||||||||||||||||||||||-|----|||||||||||||||||||||||||||||||||
-------------------------||||||||||||%%|%%|||||||||||||||||||||||----|||||------|||||||||||||||||||||||||||||||-|-----|||||||||||||||||||||||||||||-||
------%%%%%--------------||||||||||||||||||||||||||||||||||||||||----|||||-------||||||||||||||||||||||||||||||||-----||||||||||||||||||||||||||||--||
XXXXXX|||||XXXXXXXXXXXXXX|||||||||||||||||||||||||||||||||||||XXXXXXXXXXXXXXXXXXXXX|||||||||||||XX|||||||||||||XXXXXXXX|||||||||X||XX|||||||||||XXXX||
