------------------------------------------------------------------------------------------------------------------------------------------------------
------------------------------------------------------------------------------------------------------------------------------------------------------
------------------------------------------------------------------------------------------------------------------------------------------------------
------------------------------------------------------------------------------------------------------------------------------------------------------
------------------------------------------------------------------------------------------------------------------------------------------------------
------------------------------------------------------------------------------------------------------------------------------------------------------
------------------------------------------------------------------------------------------------------------------------------------------------------
------------------------------------------------------------------------------------------------------------------------------------------------------
------------------------------------------------------------------------------------------------------------------------------------------------------
------------------------------------------------------------------------------------------------------------------------------------------------------
----------------------------------g----------------------k--------------------------------------------------------------------------------------------
-------------------------------------ggggggggg-------------------%%%----------------------------------------------------------------------------------
--------------------------------%%%-----------------------------||||%-------%%%%%%%-------------------------------------------------------------------
--------------------------------|||----------------------------%|||||%%--%%%||||||||-----------------------------%%-----------------------------------
------%%%%%---------------------||-----------------------------||||||||--|||||||||||-----------------------------||-----------------------------------
XXXXXX|||||XXXXXXXXXXXXXX---XXXXXXXXXXX--------XXXXXXXXXXX-XXX-||||||||--|||||||||||---XXXXXXXXXXXXXXXXXXXXXXXXXX|XX----XXXXXXX---XX---XXXXXX---------
