------------------------------------------------------------------------------------------------------------------------------------------------------
------------------------------------------------------------------------------------------------------------------------------------------------------
------------------------------------------------------------------------------------------------------------------------------------------------------
------------------------------------------------------------------------------------------------------------------------------------------------------
------------------------------------------------------------------------------------------------------------------------------------------------------
------------------------------------------------------------------------------------------------------------------------------------------------------
------------------------------------------------------------------------------------------------------------------------------------------------------
------------------------------------------------------------------------------------------------------------------------------------------------------
------------------------------------------------------------------------------------------------------------------------------------------------------
--------------------------------------------------------S--------------------------------------------------------------------------------------------%
--------------------------------------------Sg------------ggg------------------------------g----------------------------------------------------------
----------------------------------------------------------------------------------------------%%--%%------------------------%%%%%%%%%%%%%%%%%%%%%%%%%%
----------------------------------------------------------------------------------------------||--------%%%%%%%%%-%----%F%%%||||||||||||||||||||||||||
---------------------------------------------%%%%%%%%%%%%%%%%%%%%-----%%%--------------%%%%%%%%%%%%%%%%%%||||||||------|||||||||||||||||||||||||||||||
------%%%%%---------------------------------||||||||||||||||||||------|||-----------%%%|||||||||||||||||||||%%%%%%%%%%%|||||||||||||||||||||||||||||||
XXXXXX|||||XXXXXXXXXXXXXX-----XXXXXXXXXXXXXX|||||||||||||||||||||----||||------XXX--||||||||||||||||||||||||||||||||||||||||||||||||||||||||||||||||||
