------------------------------------------------------------------------------------------------------------------------------------------------------
------------------------------------------------------------------------------------------------------------------------------------------------------
------------------------------------------------------------------------------------------------------------------------------------------------------
------------------------------------------------------------------------------------------------------------------------------------------------------
------------------------------------------------------------------------------------------------------------------------------------------------------
------------------------------------------------------------------------------------------------------------------------------------------------------
-------------------------------------------------------------------------------------------------------------S----------------------------------------
------------------------------------------------------------------------------------------------------------------------------g-%---------%%----------
----------------------------------------------------------g------------------%-----%-------%%-----------------%----|-------||--||--|---|----|--gg---|-
--------------------------------------k-kg-gggk---------------%%%%%%--------------|||-g|gkSg|%-%%%%%%%%|----%%-%%%-|--------|--||--|--||--||||-||--g--
---------------------------------------------------------------gg--C|ggggg---------||-|||||||||ggg||||||%%%||||||||||%%%%%%%%%%%%%%%%%||%-||||||---|--
--------------------------------%%----k--||---|g---%%%----kk---------------kggkgggg%%%%%%%%|||||||||||||||||||||||||||||||||||||||||||||||------------
--------------------------------------|-%%%|%%|||||||||---||---------------||----|||||||||||||||||||||||||||||||||||||||||||||||||||||||||-2%--%------
-------------------------%%%%%%%%%%%%%%%|||||||||||||||---||---------------|%%%%%%%%||||||||||||||||||||||||||||||||||||||||||||||||||||||-||--|------
------%%%%%--------------||||||||||||||||||||||||||||||---||---------------|||||||||||||||||||||||||||||||||||||||||||||||||||||||||||||||-||--|------
XXXXXX|||||XXXXXXXXXXXXXX|||||||||||||||XXXXXXXXXXX|||X--XXXXXXXXXXXXXXXXXXXXXXXXXXXXX|||||||||||||||||||||||||||||||||||||||-||||X||||||||||XX|XXXXXX
