------------------------------------------------------------------------------------------------------------------------------------------------------
------------------------------------------------------------------------------------------------------------------------------------------------------
------------------------------------------------------------------------------------------------------------------------------------------------------
------------------------------------------------------------------------------------------------------------------------------------------------------
------------------------------------------------------------------------------------------------------------------------------------------------------
------------------------------------------------------------------------------------------------------------------------------------------------------
------------------------------------------------------------------------------------------------------------------------------------------------------
------------------------------------------------------------------------------------------------------------------------------------------------------
--------------------------------------------------------------------------------------------------------------------------------------------k---------
--------------------------------------CSC-CCk-k-----------------------------------------gkS------------------------------------------------|||----g---
---------------------------------------------------------------------------------------||----%%%%%%%%%%%%%%%%%%%||||%%%%%%%%%%%%%%%%%%%%%%%||||-------
-----------------------------------U------------%%%%%%%----k-----------------gg-ggk-kg-|||--||||||||||||||||||||||||||||||||||||||||||||||||||||------
-----------------------------------------%%|%%%%||||||||---|---------------------------||%%%||||||||||||||||||||||||||||||||||||||||||||||||||||------
-------------------------%%%%%%%%-%-%%%|||||||||||||||||---|--------------------------||||||||||||||||||||||||||||||||||||||||||||||||||||||||||------
------%%%%%--------------||||||||||%||||||||||||||||||||--||--------------------------||||||||||||||||||||||||||||||||||||||||||||||||||||||||||%%----
XXXXXX|||||XXXXXXXXXXXXXX||||||||||||XXXXXXXXXX||||||||---XXXXXXXXXXXXXXXXXXXXXXXXXXXXXX||||||||||||||||||||||||||||||||||||||||||||||||||||||||||XXXX
