------------------------------------------------------------------------------------------------------------------------------------------------------
------------------------------------------------------------------------------------------------------------------------------------------------------
------------------------------------------------------------------------------------------------------------------------------------------------------
------------------------------------------------------------------------------------------------------------------------------------------------------
------------------------------------------------------------------------------------------------------------------------------------------------------
------------------------------------------------------------------------------------------------------------------------------------------------------
------------------------------------------------------------------------------------------------------------------------------------------------------
------------------------------------------------------------------------------------------------------------------------------------------------------
------------------------------------------------------------------------------------------------------------------------------------------------------
-----------------------------------------------------------C--------------------------------------------------------------------------------g---------
------------------------------------------------------------------------------------------------------------------------------------------------------
---------------------------------------------------------------------------------------------------------------------%k%%---%--%%%%%%%%%%%------------
-------------------------------------------------%%%%%-----------------------------------------%%%%%%%%%%%%%%%%%%-%-%|||F%%||%||||||||||||%2%%%%%%%%%k
----------------------------------------------%%%%||||||-%%%-----------------------%%%%%%%%%%%||||||||||||||||||||||||||||||||||||||||||||||||||||||||
------%%%%%-----------------------------------|||||||||||||||-------%%%%%%%--------|||||||||||||||||||||||||||||||||||||||||||||||||||||||||||||||||||
XXXXXX|||||XXXXXXXXXXXXXX-----XXXXXXXXXXXXXXXX||||||||||||||||------||||||||-----X-|||||||||||||||||||||||||||||||||||||||||||||||||||||||||||||||||||
