------------------------------------------------------------------------------------------------------------------------------------------------------
------------------------------------------------------------------------------------------------------------------------------------------------------
------------------------------------------------------------------------------------------------------------------------------------------------------
------------------------------------------------------------------------------------------------------------------------------------------------------
------------------------------------------------------------------------------------------------------------------------------------------------------
------------------------------------------------------------------------------------------------------------------------------------------------------
------------------------------------------------------------------------------------------------------------------------------------------------------
------------------------------------------------------------------------------------------------------------------------------------------------------
------------------------------------------------------------------------------------------------------------------------------------------------------
------------------------------------------------------------------------------------------------------------------------------------------------------
-------------------------------------------------------------------------------------------------g---%%%------%%%%%%%%%%%%%%%%%%%-%%%-%%--------------
---------------------------------------------------%%-----------------------ggg--gggkg---------------|||g%%%%%|||||||||||||||-|||-k||-|||-------------
-----------------------------------------%%-%---%%|||----------------------------------%%%%%%%%---%%|||||||||||||||||||||||||-|||-|||-|||--2----------
-------------------------%%%%%--------g--|||||||||||||-----------------------%%%%%%%---||||||||--||||||||||||||||||||||||||||-|||-|||-|||-------------
------%%%%%--------------||||||%%|k%--|--|||||||||||||-----------------------||||||----|-||||||--||||||||||||||||||||||||||||-|||-||||||||%%%---------
XXXXXX|||||XXXXXXXXXXXXXX|||||||||||||XXXXXXXXXXXXXXXXX--XXXXXXXXXXXXXXXXXXXXXXXXXXXXXXXXX||||||||||||||||||||||||||||||||||||||||||||||||||||XXXXXXXX
