------------------------------------------------------------------------------------------------------------------------------------------------------
------------------------------------------------------------------------------------------------------------------------------------------------------
------------------------------------------------------------------------------------------------------------------------------------------------------
------------------------------------------------------------------------------------------------------------------------------------------------------
------------------------------------------------------------------------------------------------------------------------------------------------------
------------------------------------------------------------------------------------------------------------------------------------------------------
------------------------------------------------------------------------------------------------------------------------------------------------------
------------------------------------------------------------------------------------------------------------------------------------------------------
------------------------------------------------------------------------------------------------------------------------------------------------------
------------------------------------------------------------------------------------------------------------------------------------------------------
--------------------------------------------------------------------------------------------------------------------------------%%--%-----------------
--------------------------------------------------------------------------------------------------------%%%%%%%%%%%%%%X%%-------|--||--||-------------
-----------------------------------------------%%%%%%%-----------------------------------%%%%%%%%%%%%%%||||||||||||||||||%%%%%%%%%||||||||%2%-%----%%-
------------------------------------------------||||||--------------------------------%|-||||||||||||||||||||||||||||||||||||||||||||||||||||||----|--
------%%%%%-------------------------------------|||||||---|---------------------------||-|||||||||||||||||||||||||||||||||||||||||||||||||||%%%%%%%|-|
XXXXXX|||||XXXXXXXXXXXXXX-----XXXXXXXXXXXXXXXXXX|||||||---||----XXXXXXXXXXXXXXXXXXXXXXX|||||||||||||||||||||||||||||||||||||||||||||||||||||||||||||||
