------------------------------------------------------------------------------------------------------------------------------------------------------
------------------------------------------------------------------------------------------------------------------------------------------------------
------------------------------------------------------------------------------------------------------------------------------------------------------
------------------------------------------------------------------------------------------------------------------------------------------------------
------------------------------------------------------------------------------------------------------------------------------------------------------
------------------------------------------------------------------------------------------------------------------------------------------------------
------------------------------------------------------------------------------------------------------------------------------------------------------
------------------------------------------------------------------------------------------------------------------------------------------------------
------------------------------------------------------------------------------------------------------------------------------------------------------
------------------------------------------------------------------------------------------------------------------------------------------------------
------------------------------------------------------------------------------------------------------------------------g---------------%%%%%%--------
-----------------------------------U-------------%%----------ggggkg--gg--------------------------------g---------k----------------------||||||--------
-------------------------------------------------||-------------------------------------------|-----------------%|%------%---%%---%--|-|||||||--------
------------------------------------------------%|%%%%%%%---%-%%%%%---%----------------------||---%%%--%%%--%|-|||-------||--||---|--|||||||||%-------
------%%%%%-------------------------|-----------||||-||-|---|-|||||------------|------------%|||--|||--|||--||%%%|%%%%%%%%%-%||%--|%%||-|||||||------%
XXXXXX|||||XXXXXXXXXXXXXX---XXXXXXXXXXXXXXXX-|XX|XXXXXXX|--||XXXX||XXXXXXX--XXXXXXXXXXXXXX--X|||--|||XX|||-||||||||||||||||-||||-|||||||||||||||-|--||
