------------------------------------------------------------------------------------------------------------------------------------------------------
------------------------------------------------------------------------------------------------------------------------------------------------------
------------------------------------------------------------------------------------------------------------------------------------------------------
------------------------------------------------------------------------------------------------------------------------------------------------------
------------------------------------------------------------------------------------------------------------------------------------------------------
------------------------------------------------------------------------------------------------------------------------------------------------------
------------------------------------------------------------------------------------------------------------------------------------------------------
------------------------------------------------------------------------------------------------------------------------------------------------------
------------------------------------------------------------------------------------------------------------------------------------------------------
------------------------------------------------------------------------------------------------------------------------------------------------------
-----------------------------------------------------------------------------------------------------------------------------------------------%%%%%%%
------------------------------------------------------------------------------------------g--------------------------------------------------|||||||||
--------------------------------------------------------%%%--%%%%----%%%%%%-----------------------------------------------------------------||||||||||
-------------------------------%%-%|-|------%%%%%%----%|||||||||||%%%|||||||%----|||||%%%%%--%%%%%--------------------%%%%%%%%%%%%%%%%%%%%%|||||||||||
------%%%%%--------------------|||||-|------||||||--||||||||||||||||||||||||||-%||||||||||||-||||||%|%%%%%%|%---------||||||||||||||||||||||||||||||||
XXXXXX|||||XXXXXXXXXXXXXX----XXXXXXXXXX---|||||||||-||||||||||||||||||||||||||-|||||||||||||--||||||||||||||||------XX||||||||||||||||||||||||||||||||
