------------------------------------------------------------------------------------------------------------------------------------------------------
------------------------------------------------------------------------------------------------------------------------------------------------------
------------------------------------------------------------------------------------------------------------------------------------------------------
------------------------------------------------------------------------------------------------------------------------------------------------------
------------------------------------------------------------------------------------------------------------------------------------------------------
------------------------------------------------------------------------------------------------------------------------------------------------------
------------------------------------------------------------------------------------------------------------------------------------------------------
------------------------------------------------------------------------------------------------------------------------------------------------------
------------------------------------------------------------------------------------------------------------------------------------------------------
--------------------------------------------------------------------------------------------------------------------------------------------g-S-S-----
------------------------------------------------------g-------------------------------------------------------------------------%%--%-----------------
-------------------------------------------------------------------------------------------------------%%%%%%%%%%%%%%%----------||||||%%%%%-----------
----------------------------------------------%%%%%%%--------------------------------------%%%%%%%%%%%%|||||||||||||%%%%F%%%%%%%%%%%|||||||2%%%%%-----
----------------------------------------------|||||||%%%--%%%-------------------------%%%%|||||||||||||||||||||||||||||||||||||||||||||||||||||||--%|%
------%%%%%-----------------------------------||||||||||--|||-------------------------|||||||||||||||||||||||||||||||||||||||||||||||||||||||||%%%%|||
XXXXXX|||||XXXXXXXXXXXXXX-----XXXXXXXXXXXXXXXXX|||||||||--|||----XXXXXXXX--XXXXXXXXXXXX|||||||||||||||||||||||||||||||||||||||||||||||||||||||||||||||
