------------------------------------------------------------------------------------------------------------------------------------------------------
------------------------------------------------------------------------------------------------------------------------------------------------------
------------------------------------------------------------------------------------------------------------------------------------------------------
------------------------------------------------------------------------------------------------------------------------------------------------------
------------------------------------------------------------------------------------------------------------------------------------------------------
------------------------------------------------------------------------------------------------------------------------------------------------------
------------------------------------------------------------------------------------------------------------------------------------------------------
------------------------------------------------------------------------------------------------------------------------------------------------------
------------------------------------------------------------------------------------------------------------------------------------------------------
---------------------------------------------------------SSC--g----------------------------------------------------------------------------%%%%%%%-%%-
---------------------------------------------------------------------------------------------------------------------------%%%--------------|-|||-|||-
-------------------------------------------------------------------------------------------%%%%-%%--%-----%%%%%%---%%%k%%--|||%%%%%%%%%%%%%----||||||-
-----------------------------------------------%%%%%%%%%%%%%%%---------%%-------------%%%%%|||||||%%%%%%%%%%%%||--%|||||||||||||||||||||||%2%%%%%%%%%k
--------------------------g---%%%%%--%%---%%%%||||||||||-|||---------------------%%%%%|||||||||||||||||||||||||||-||||||||||||||||||||||||||||||||||||
------%%%%%-------------------|||||--||---|||||||||||||%-%||--------%%%%%%%-------||||||||||||||||||||||||||||||||||||||||||||||||||||||||||||||||||||
XXXXXX|||||XXXXXXXXXXXXXX-----XXXXXXXXXXXXXXXX||||||||||||||-------X||||||||X---XX||||||||||||||||||||||||||||||--||||||||||||||||||||||||||||||||||||
