------------------------------------------------------------------------------------------------------------------------------------------------------
------------------------------------------------------------------------------------------------------------------------------------------------------
------------------------------------------------------------------------------------------------------------------------------------------------------
------------------------------------------------------------------------------------------------------------------------------------------------------
------------------------------------------------------------------------------------------------------------------------------------------------------
------------------------------------------------------------------------------------------------------------------------------------------------------
------------------------------------------------------------------------------------------------------------------------------------------------------
------------------------------------------------------------------------------------------------------------------------------------------------------
------------------------------------------------------------------------------------------------------------------------------------------------------
----------------------------------------S-------------------------------------------------------------------------------------------------------------
--------------------------------------------------------------------------------------------------------------------%%%%%-------%---%-----------------
----------------------------------------------------------------------------------gg--------------------g%%%%%%%%%%%%%|||-----------|---g-------------
-------------------------------------------------%%%%-------------------------------------%%%%%%%%%%%%%%|||||||||||||||||--%--%%%--%%--||-------------
--------------------------------------g----------||||-----------------------%%%%%%%-------||||---||||||||||||||||||||||||--|--|||--||--||-------------
------%%%%%--------------%%-X--%%X----------------|||------------------------|||||---------||%%%%%%%|||||||||||||||||||||%%|%%%||--||--|%%%%%%%%%%%---
XXXXXX|||||XXXXXXXXXXXXXX||||||||||XXXXXXXXXXXXXXXX||X----XXXXXXXXXXX---XXXXXXXXXXXXXXXXXXX|||||||||||||||||||||||||||||||||||||||-||||||||||||||-|--X
