------------------------------------------------------------------------------------------------------------------------------------------------------
------------------------------------------------------------------------------------------------------------------------------------------------------
------------------------------------------------------------------------------------------------------------------------------------------------------
------------------------------------------------------------------------------------------------------------------------------------------------------
------------------------------------------------------------------------------------------------------------------------------------------------------
------------------------------------------------------------------------------------------------------------------------------------------------------
------------------------------------------------------------------------------------------------------------------------------------------------------
------------------------------------------------------------------------------------------------------------------------------------------------------
------------------------------------------------------------------------------------------------------------------------------------------------------
------------------------------------------------------------------------------------------------------------------------------------------------------
--------------------------------------------------------------------------------------------g---------------%---%-------%-g---%--%%%%%%%%%%%----------
-----------------------------------gk------------%%%---------------------------------------------------%%%%-%||||%%%%%-----------||-||-|||||----------
--------------------------------------------%%---|||---------------------------------------%%%%%%-%|--||||--|||||||||||%F%%%%%%%%%%%%%%|||||----------
---------------------------------------------|--||||%%%-----%-----%------------------------|||||||||%%%%%%%%|||||||||||||||||||||||||||||||||---------
------%%%%%--------------------%%---------------||||||||----|------------------------------|||||||||||||||||||||||||||||%||||||||||||||||||||%%%%%---%
XXXXXX|||||XXXXXXXXXXXXXX---X-|||XXXXXXXXXXXXXXXX|||||||---XXXXXXXXXXXXXXXXXXXXXXXXXXXXXXX-|||||||||||||||||||||||||||||||||||||||||||||||||||||||---|
