------------------------------------------------------------------------------------------------------------------------------------------------------
------------------------------------------------------------------------------------------------------------------------------------------------------
------------------------------------------------------------------------------------------------------------------------------------------------------
------------------------------------------------------------------------------------------------------------------------------------------------------
------------------------------------------------------------------------------------------------------------------------------------------------------
------------------------------------------------------------------------------------------------------------------------------------------------------
------------------------------------------------------------------------------------------------------------------------------------------------------
------------------------------------------------------------------------------------------------------------------------------------------------------
------------------------------------------------------------------------------------------------------------------------------------------------------
------------------------------------------------------------------------------------------------------------------------------------------------------
---------------------------------------------------------------------------------------------------------------------------------------------------%--
--------------------------------------------------------------------------------------------------------------------g-----------------------------||--
---------------------------------%%----------------------------%%%%%%%%%%%%%%%%%%%%%%%------------------------------------------------------------||--
--------------------------------%||----------------------------|||||||||||||||||||||%%%---------------------------%%%%%-------------------------||||||
------%%%%%---------------------|||----------------------%-----||||||||||||||||||||||||---------------------------------------------------------||||||
XXXXXX|||||XXXXXXXXXXXXXX----XXXXXXXXX------X--XXXX----XX|----||||||||||||||||||||||||||--XX---XXX-------XXX--XXXX--XXX--XXXX--XX--------------|||||||
