------------------------------------------------------------------------------------------------------------------------------------------------------
------------------------------------------------------------------------------------------------------------------------------------------------------
------------------------------------------------------------------------------------------------------------------------------------------------------
------------------------------------------------------------------------------------------------------------------------------------------------------
------------------------------------------------------------------------------------------------------------------------------------------------------
------------------------------------------------------------------------------------------------------------------------------------------------------
-------------------------------------------------------------------------------------------------------------------------------SSSCS----SCC%----------
-------------------------------------------------------------------------------------------------%C------%--------------------------------------------
----------------------------------------------------------------g-------------------------------g||-|--ggk-g---------------------------------%%%%%%%--
-------------------------------------------S%%-%%%%%%%%%%%%%%---------ggSkS-----------------------|--------------r%%%%%%%%%%%%%%%%%%%%%%%%%%%|||||||%%
--------------------------------r---kgkkggggg-----||||||--|k-g--------------------g-k%g%gg%%%%%%%%%%%%%%%%%%%%%g-||||||||||%||||||||||||||||||||||||||
-----------------------------------U--------||-||||||||||||||||g-----g--|-------k-k-|||||||||||||||||||||||||||-||---|||||||||||||||||||||||||||||||||
--------------------------------------------|%%%|||||||||||||||--------||------------||||||||||||||||||||||||||%%|%|%|||||||||||||||||||||||||||||||||
--------------------------g%%-%%%%%%%%%%%%%%|||||||||||||||||||--------||------------|||||||||||||||||||||||||||||-|||||||||||||||||||||||||||||||||||
------%%%%%-------------------||||||||||||||||||||||||||||||||||-------||------------|||||||||||||||||||||||||||||%%||||||||||||||||||||||||||||||||||
XXXXXX|||||XXXXXXXXXXXXXX---|||||||||XXXX||||||||||||||||||||||XXXXXXXXXXXXXXXXXXXXXX|||||||||||||||||||||||||||||||||||||||||||||||||||||||||||||||||
