------------------------------------------------------------------------------------------------------------------------------------------------------
------------------------------------------------------------------------------------------------------------------------------------------------------
------------------------------------------------------------------------------------------------------------------------------------------------------
------------------------------------------------------------------------------------------------------------------------------------------------------
------------------------------------------------------------------------------------------------------------------------------------------------------
------------------------------------------------------------------------------------------------------------------------------------------------------
------------------------------------------------------------------------------------------------------------------------------------------------------
------------------------------------------------------------------------------------------------------------------------------------------------------
--------------------------------------------------------------------------------------------------------------------------------------------k---------
--------------------------------------CSSCSCk-----------------------------------------g-g-------------------------------------------------------------
----------------------------------------------------------------------------------------------gg--%%-%%%%-%%%%%%%%%%%%%%%%%%%%%%%%%%%%%%%%%%----------
--------------------------------%--g-------------%%%%%------------------------g-gg----------------||-|||||||||||||||||||||||--||||||||||||||----------
-----------------------------------------%%-%%%%%|||||----------------------------------%%%%%%%%%%||-|||||||||||||||||||||||-|||||%|||||||||----------
----------------------------------------||-||||||||||%-----------------------------------||||||||||||||||||||||||||||||||||||||||||||||||||||---------
------%%%%%--------------%%-X-|%%X-%--------|||||||||||----------------------------------|||||||||||||||||||||||||||||||||||||||||||||||||||%%%%%-----
XXXXXX|||||XXXXXXXXXXXXXX|||||||||||XXXXXXXXXXXXXXX|||X---XXXXXXXXXXXXXXXXXXXXXXXXXXXXXXXX|||||||||||||||||||||||||||||||||||||||||||||||||||||||XXXXX
