------------------------------------------------------------------------------------------------------------------------------------------------------
------------------------------------------------------------------------------------------------------------------------------------------------------
------------------------------------------------------------------------------------------------------------------------------------------------------
------------------------------------------------------------------------------------------------------------------------------------------------------
------------------------------------------------------------------------------------------------------------------------------------------------------
------------------------------------------------------------------------------------------------------------------------------------------------------
------------------------------------------------------------------------------------------------------------------------------------------------------
------------------------------------------------------------------------------------------------------------------------------------------------------
------------------------------------------------------------------------------------------------------------------------------------------------------
--------------------------------------CSCSCCCC------------------------------------------g-----------------------------------------------------S-------
--------------------------------------------------------------------------------------------g----%%%--%-----%%%------%%%%%%%%%%%%%%%%%%%%%%%%---------
-----------------------------------g--------------%%%-------------------------g-------------------||-%%%%%%%%%%%%%%%%||||||||||||||||||||||||---------
--------------------------------------------%%%%%%||||----------------------------------%%%%%%%%%%|||||||||||||||||||||||||||||||||||||||||||||-------
--------------------------------------------||||||||||%----%----------------------------|||||||||||||||||||||||||||||||||||||||||||||||||||||||-------
------%%%%%--------------------%%-----------|||||||||||----||---------------------------||||||||||||||||||||||||||||||||||||||||||||||||||||||%%%%%--%
XXXXXX|||||XXXXXXXXXXXXXX-----||||XXXXXXXXXXXXXX||||||||---||--XXXXXXXXXXXXXXXXXXXXXXXXXX|||||||||||||||||||||||||||||||||||||||||||||||||||||||||||||
