------------------------------------------------------------------------------------------------------------------------------------------------------
------------------------------------------------------------------------------------------------------------------------------------------------------
------------------------------------------------------------------------------------------------------------------------------------------------------
------------------------------------------------------------------------------------------------------------------------------------------------------
------------------------------------------------------------------------------------------------------------------------------------------------------
------------------------------------------------------------------------------------------------------------------------------------------------------
------------------------------------------------------------------------------------------------------------------------------------------------------
------------------------------------------------------------------------------------------------------------------------------------------------------
------------------------------------------------------------------------------------------------------------------------------------------------------
------------------------------------------------------------------------------------------------------------------------------------------------------
-----------------------------------------------------------------------------------------------------------------%%-----------------------------------
------------------------------------gk------------g---------------------------%%--------------------------g----|||||%---------------------------------
------------------------------------------------------------------------------||-------------------------------|||||||--------------------------------
-----------------------------------------------------------------%%%%------%%%%%%%%-------------------%%------%|||||||--------------------------------
------%%%%%--------------%%-----%Xk------------------------------||||-------|||||||-------------------||------||||||||%%----------------%%%-----------
XXXXXX|||||XXXXXXXXXXXXXX-||||XXX|XXXXXXXXXXXXXXXXXXXXXXXXXXXXXXXX|||-----X|||||||XXXXXXXXXXXX----XXXXXXXXXXXX|||||||||-----------XXX--X|||XXXX------X
