------------------------------------------------------------------------------------------------------------------------------------------------------
------------------------------------------------------------------------------------------------------------------------------------------------------
------------------------------------------------------------------------------------------------------------------------------------------------------
------------------------------------------------------------------------------------------------------------------------------------------------------
------------------------------------------------------------------------------------------------------------------------------------------------------
------------------------------------------------------------------------------------------------------------------------------------------------------
----------------------------------------------------------------------------------------|-ggkCU-----------------------2--||-------SkS|--------%-------
---------------------------------------------------------%-----------------------%--||----------------------S%S%S-----------------------------||-g----
----------------------------------------------------------------g2-|---------------------------%%%%%%-%%%%-%g-----------------g------%--%%%--||--|%%%%
--------------------------------------------------g||ggg-|-----|-----%%%%-%%gg---|----------g-g||||||||||||||----rgCSSC%%%%%%%%%%%%%%%|-|||---|-||||||
--------------------------------------Xgg%%%g-----|g||-------|g|-----||||||||--%%%%%%%%%%%%%%%|||||||||||||||g-g------|||||||||||||||||||||%%%%%%%%%%%
-------------------------%%%%%%%%--%|--|||||||%|||||||%%%%%%%%|||g-g||||||%%|--C|||||||||||||||||||||||||||||||--S----||||||||||||||||||||||||||||||||
-------------------------|||||||||%||%-|||||||||||||||||||||||||||--||||||||----||||||||||||||||||||||||||||||---------|||||||||||||||||||||||||||||||
-------------------------||||||||||||||%%%%%%||||||-||||||||||||||--||||||||----||||||||||||||||||||||-|||||||---------|||||||||||||||||||||||||||||||
------%%%%%--------------||||||||||||||||||||||||||-||||||||||||||--||||||||----||||||||||||||||||||||--||||||---------|||||||||||||||||||||||||||||||
XXXXXX|||||XXXXXXXXXXXXXX||||||||||||||||||||||||||||||||||||||||XXXXXX||XXXXXXXX|||||||||||XXXXXXXX||-X||||||XXXXXXXXXXXX|XXXXXXX|XX|XXXX||||||||||||
