------------------------------------------------------------------------------------------------------------------------------------------------------
------------------------------------------------------------------------------------------------------------------------------------------------------
------------------------------------------------------------------------------------------------------------------------------------------------------
------------------------------------------------------------------------------------------------------------------------------------------------------
------------------------------------------------------------------------------------------------------------------------------------------------------
------------------------------------------------------------------------------------------------------------------------------------------------------
------------------------------------------------------------------------------------------------------------------------------------------------------
------------------------------------------------------------------------------------------------------------------------------------------------------
------------------------------------------------------------------------------------------------------------------------------------------------------
------------------------------------------------------------------------------------------------------------------------------------------------------
------------------------------------------------------------------------------------------------------------------------------------------------------
------------------------------------------------------------------------------------------------------------------------------------------------------
-------------------------------------------------------------------------------------------------------------------------------------%%-%-------------
------------------------------------------------%%%%%%%%%%%%%%%%%%%%%%%%%%%-------------------%%%%%%%%%%%%%%%%%%%%%%%%%--%%--%%-%%%%%%%%%%%%%%%%%%%%%%
------%%%%%-------------------------------------|||||||||||||||||||||||||||--%%%%------------|||||||||||||||||||||||||%%%%%%%%%%||||||||||||||||||||||
XXXXXX|||||XXXXXXXXXXXXXX----XXXXXXXXXXXXXX---XX|||||||||||||||||||||||||-|-|||||------------|||||||||||||||||||||||||||||||||||||||||||||||||||||||||
