------------------------------------------------------------------------------------------------------------------------------------------------------
------------------------------------------------------------------------------------------------------------------------------------------------------
------------------------------------------------------------------------------------------------------------------------------------------------------
------------------------------------------------------------------------------------------------------------------------------------------------------
------------------------------------------------------------------------------------------------------------------------------------------------------
------------------------------------------------------------------------------------------------------------------------------------------------------
------------------------------------------------------------------------------------------------------------------------------------------------------
------------------------------------------------------------------------------------------------------------------------------------------------------
------------------------------------------------------------------------------------------------------------------------------------------------------
--------------------------------------S-------------------------------------------------g-S-----------------------------------------------------------
------------------------------------------------------------------------------------------------------------------------%---%--%%---------------------
-------------------------------------------------------------------------------------------------------%%%%%%%%%%%%%%%|%|--||--||--||-||--------------
-----------------------------------------------%%%%%%------------------------------------%%%%%%%%%%%%%%%||||||||||||||||||%||%%%|%|||||||-%2%%%%%%%---
--------------------------------------g-------||||||||-----------------------%-----%%%%--|||||||||||||||||||||||||||||||||||||||||||||||||||||----|---
------%%%%%--------------------%%-------------|||||||||---|------------------|--------||||||||||||||||||||||||||||||||||||||||||||||||||||%%%%%%%%%---
XXXXXX|||||XXXXXXXXXXXXXX-----|||||XXXXXXXXXXXXXX||||||---|---XXXXXXXXXXXXXXXXXXXXXXXXXXX|||||||||||||||||||||||||||||||||||||||||||||||||||||||||||--
