------------------------------------------------------------------------------------------------------------------------------------------------------
------------------------------------------------------------------------------------------------------------------------------------------------------
------------------------------------------------------------------------------------------------------------------------------------------------------
------------------------------------------------------------------------------------------------------------------------------------------------------
------------------------------------------------------------------------------------------------------------------------------------------------------
------------------------------------------------------------------------------------------------------------------------------------------------------
------------------------------------------------------------------------------------------------------------------------------------------------------
------------------------------------------------------------------------------------------------------------------------------------------------------
------------------------------------------------------------------------------------------------------------------------------------------------------
------------------------------------------------------------------------------------------------------------------------------------------------------
------------------------------------------------------------------------------------------------------------------------------------------------------
------------------------------------------------------------------------------------------------------------------------------------------------------
------------------------------------------------------------------%%%---------------------------------------------------------------------------------
-----------------------------------------------------------------||||-----%%%%%%%%%%%%---------------------%---%%%%%%%%---------------------------%%--
------%%%%%-----------------------------------------------------|%|%%%%-%%%|||||||||||------------%---%----|---||||||||--------------------------|||--
XXXXXX|||||XXXXXXXXXXXXXX----XXXXXXXXX-XX--XXXXXXXXXX----------X|||||||--|||||||||||||XXXXXX-------X-||---X|---||||||||-----|------|------------||||--
