------------------------------------------------------------------------------------------------------------------------------------------------------
------------------------------------------------------------------------------------------------------------------------------------------------------
------------------------------------------------------------------------------------------------------------------------------------------------------
------------------------------------------------------------------------------------------------------------------------------------------------------
------------------------------------------------------------------------------------------------------------------------------------------------------
------------------------------------------------------------------------------------------------------------------------------------------------------
------------------------------------------------------------------------------------------------------------------------------------------------------
------------------------------------------------------------------------------------------------------------------------------------------------------
------------------------------------------------------------------------------------------------------------------------------------------------------
------------------------------------------------------------------------------------------------------------------------------------------------------
----------------------------------g----------------------k--------------------------------------------------------------------------------------------
-------------------------------------g----------------------------------------------------------------------------------------------------------------
------------------------------------------------------------------------------------------------------------------------------------------------------
----------------------------------------------------------------%%%%%%----%%%%%%%%%%---------------------------%%%%%%%--------------------------------
------%%%%%-----------------------------------------------------||||||----||||||||||---------------------------|||||||------------------%%%-----------
XXXXXX|||||XXXXXXXXXXXXXX----XXXXXXXXXXXX---XXXXXXXXX--X-----X-|||||||----||||||||||--XXXXXXX--------X----XX---|||||||-------------------|------------
