------------------------------------------------------------------------------------------------------------------------------------------------------
------------------------------------------------------------------------------------------------------------------------------------------------------
------------------------------------------------------------------------------------------------------------------------------------------------------
------------------------------------------------------------------------------------------------------------------------------------------------------
------------------------------------------------------------------------------------------------------------------------------------------------------
------------------------------------------------------------------------------------------------------------------------------------------------------
------------------------------------------------------------------------------------------------------------------------------------------------------
------------------------------------------------------------------------------------------------------------------------------------------------------
------------------------------------------------------------------------------------------------------------------------------------------------------
------------------------------------------------------------------------------------------------------------------------------------------------------
---------------------------------------------------------k--------------------------------------------------------------------------------------------
---------------------------------------g--------------------------------------------------------------------------------------------------------------
--------------------------------%%%------------------------------|%---------%%%%%%%-------------------------------------------------------------------
--------------------------------||----------------------------%%%%%%%%%%%%%%|||||||--------------------------------------------------------------%%%%-
------%%%%%---------------------------------------------------|||||||||||||||||||||%-------------------------------------------------------------|-|||
XXXXXX|||||XXXXXXXXXXXXXX---XXXXXXXXXXX--------XXXXXXXXXX---XX||||||||||||||||||||||----XXXXXXXXX---XXXXXXXXXXXXXXX-----XXXXX-----------XXX------|-|||
