------------------------------------------------------------------------------------------------------------------------------------------------------
------------------------------------------------------------------------------------------------------------------------------------------------------
------------------------------------------------------------------------------------------------------------------------------------------------------
------------------------------------------------------------------------------------------------------------------------------------------------------
------------------------------------------------------------------------------------------------------------------------------------------------------
------------------------------------------------------------------------------------------------------------------------------------------------------
------------------------------------------------------------------------------------------------------------------------------------------------------
------------------------------------------------------------------------------------------------------------------------------------------------------
------------------------------------------------------------------------------------------------------------------------------------------------------
---------------------------------------------------------S--g-----------------------------------------------------------------------------------------
---------------------------------------------g------------g-------------------------------------------------------------------------------------------
------------------------------------------------------------------------------------------------------------------------------%%%%%%%%%%%%%%%%%%%%%%%%
-------------------------------------------------------------------------------------------------------%%%%%%%%---------------||||||||||||||||||||||||
--------------------------------------------%%%%%%%%%%%%%%%%%%%%-----%%%%%---------%%%%%%%%%%%%%%%%%%%%||||||||-----%%%%%%%%%%||%%||||||||||||||||||||
------%%%%%---------------------------------||||||||||||||||||||---%%%||||%--------||||||||||||||||||||||||||||%%%%%||||||||||||||||||||||||||||||||||
XXXXXX|||||XXXXXXXXXXXXXX-----XXXXXXXXXXXXX-||||||||||||||||||||----|||||||-------||||||||||||||||||||||||||||||||||||||||||||||||||||||||||||||||||||
