------------------------------------------------------------------------------------------------------------------------------------------------------
------------------------------------------------------------------------------------------------------------------------------------------------------
------------------------------------------------------------------------------------------------------------------------------------------------------
------------------------------------------------------------------------------------------------------------------------------------------------------
------------------------------------------------------------------------------------------------------------------------------------------------------
------------------------------------------------------------------------------------------------------------------------------------------------------
------------------------------------------------------------------------------------------------------------------------------------------------------
------------------------------------------------------------------------------------------------------------------------------------------------------
------------------------------------------------------------------------------------------------------------------------------------------------------
------------------------------------------------------------------------------------------------------------------------------------------------------
----------------------------------------------------------------------------------------------------------------------------------------------%%%%%%%%
-----------------------------------------------------------------------%---------------ggggggg--gg------------------------------------------||||||||||
-------------------------------%%%%%%-------------------%%--%%%%%%---%%%%%%%----%%%%%%------------------------------------------------------||||||||||
-------------------------------||||||--------%%%%%----%|||||||||||%%%%|||||||---|||||||-%------%%%-----------------------%%%%%%-%%%-%%%%%%%%%|||||||||
------%%%%%--------------------||||||-----%%%|S||%|---|||||||||||||||||||||||%%%%%%%%%%||------|||--|---%%%--------------||||||-|||--||-||||||||||||||
XXXXXX|||||XXXXXXXXXXXXXX---XXXXXXXXXXX--||||||||||--|||||||||||||||||||||||||||||||||||||----XX||--|---||------XX--XXXXXXXX|||-|||--|||||||||||||||||
