------------------------------------------------------------------------------------------------------------------------------------------------------
------------------------------------------------------------------------------------------------------------------------------------------------------
------------------------------------------------------------------------------------------------------------------------------------------------------
------------------------------------------------------------------------------------------------------------------------------------------------------
------------------------------------------------------------------------------------------------------------------------------------------------------
------------------------------------------------------------------------------------------------------------------------------------------------------
------------------------------------------------------------------------------------------------------------------------------------------------------
------------------------------------------------------------------------------------------------------------------------------------------------------
--------------------------------------------------------------------------------------------------------g--g------------------------------------------
-------------------------------------------------%-%%CCSSSSSgSg-------g-g--------------g-------------------------------------------------%%%%%%%%%%%%%
--------------------------------------k-SSgg----------------------------------------kg-------------------------------------%%%-%----------||||||||||||
------------------------------------------------------------------------------------------%%%%%%%%%%%%%%%-%%---------%k%%|||||%%%%%%%%%%%%%%%%||||||||
-----------------------------------------------%%%%%%%%%%%%%%%---------%%%-----------%%%%%||||||||||||||%%%%%%%%%-%-%|||||||||||||||||||||||||||||||||
--------------------------g---%%%%%%%%%%%%%%%%%|||||||||||||||---------||---------%%%||||||||||||||||||||||||||||-||||||||||||||||||||||||||||||||||||
------%%%%%-------------------|||||||||--|||||||||||||||||||||--------%%%%%-------|||||||||||||||||||||||||||||||-||||||||||||||||||||||||||||||||||||
XXXXXX|||||XXXXXXXXXXXXXX-----XXXXXXXXXXXX||||||||||||||||||||-----XXX|||||X---XXXX||||||||||||||||||||||||||||||-||||||||||||||||||||||||||||||||||||
