------------------------------------------------------------------------------------------------------------------------------------------------------
------------------------------------------------------------------------------------------------------------------------------------------------------
------------------------------------------------------------------------------------------------------------------------------------------------------
------------------------------------------------------------------------------------------------------------------------------------------------------
------------------------------------------------------------------------------------------------------------------------------------------------------
------------------------------------------------------------------------------------------------------------------------------------------------------
------------------------------------------------------------------------------------------------------------------------------------------------------
------------------------------------------------------------------------------------------------------------------------------------------------------
------------------------------------------------------------------------------------------------------------------------------------------------------
------------------------------------------------------------------------------------------------------------------------------------------------------
----------------------------------g-----------------------------------------------------------------------------%%%%----------------------------------
------------------------------------gggk-gg-g-----g--------------------------%%%%%------------------------g-----|||||---------------------------------
-------------------------------------------------------------------|---------|||||-----------------------------||||||---------------------------------
----------------------------------------------------------------%%%%%------%%%%%%%%----------------------------|||||||--------------------------------
------%%%%%--------------%%-X---%Xk--%---------------------------||||------||||||||----------------------------|||||||--------------------------------
XXXXXX|||||XXXXXXXXXXXXXX|||||XXX||XX|XXXXXXXXXXXXXXXXXXXXXXXXXXX||||-----X||||||||XXXXXXXXXXX----XXXXXXXXXXXXX|||||||------------XXX--XXXXXXXX------X
