------------------------------------------------------------------------------------------------------------------------------------------------------
------------------------------------------------------------------------------------------------------------------------------------------------------
------------------------------------------------------------------------------------------------------------------------------------------------------
------------------------------------------------------------------------------------------------------------------------------------------------------
------------------------------------------------------------------------------------------------------------------------------------------------------
------------------------------------------------------------------------------------------------------------------------------------------------------
------------------------------------------------------------------------------------------------------------------------------------------------------
------------------------------------------------------------------------------------------------------------------------------------------------------
------------------------------------------------------------------------------------------------------------------------------------------------------
------------------------------------------------------------------------------------------------------------------------------------------------------
------------------------------------------------------------------------------------------------------------------------------------------------------
--------------------------------------------------------------------------------------------------------------------%%--------------------------------
-------------------------------------------------------------------------------------------------%-%%%%%%-----------|||----%%--%%--%%--%%---%%%%%%%%%k
--------------------------------------------------%%%%----%------------------%---%%%%%%%%%%%%%%-||-|||||||%%%%%%%%%%%%%%%%%|||%||%%||%%|%%%%||||||||||
------%%%%%--------------------------------------%||||%%-%|------%%%%%%%%%%|-||--|||||||||||||||||%%%|||||||||||||||||||||||||||||||||||||||||||||||||
XXXXXX|||||XXXXXXXXXXXXXX-----XXXXXXXXXXX--XXXXXX|||||||||||-----|||||||||||||----||||||||||||||||||||||||||||||||||||||||||||||||||||||||||||||||||||
