------------------------------------------------------------------------------------------------------------------------------------------------------
------------------------------------------------------------------------------------------------------------------------------------------------------
------------------------------------------------------------------------------------------------------------------------------------------------------
------------------------------------------------------------------------------------------------------------------------------------------------------
------------------------------------------------------------------------------------------------------------------------------------------------------
------------------------------------------------------------------------------------------------------------------------------------------------------
------------------------------------------------------------------------------------------------------------------------------------------------------
------------------------------------------------------------------------------------------------------------------------------------------------------
------------------------------------------------------------------------------------------------------------------------------------------------------
------------------------------------------------------------------------------------------------------------------------------------------------------
----------------------------------g----------------------k--------------------------------------------------------------------------------------------
-------------------------------------g----------------------------------------------------------------------------------------------------------------
-----------------------------------------------------------------------------%%%----------------------------------------------------------------------
----------------------------------------------------------------%%%%%%%---%%%%||%%%%----------------------------%%%%%---------------------------------
------%%%%%----------------------------------------------------||||||||---||||||||||----------------------------|||||---------------------------------
XXXXXX|||||XXXXXXXXXXXXXX---XXXXXXXXXXXXX-----XXXXXXXXXXX---XX-||||||||---|||||||||---XXXXXXXX------XXX--XXXXXXX||||----------------------------------
