------------------------------------------------------------------------------------------------------------------------------------------------------
------------------------------------------------------------------------------------------------------------------------------------------------------
------------------------------------------------------------------------------------------------------------------------------------------------------
------------------------------------------------------------------------------------------------------------------------------------------------------
------------------------------------------------------------------------------------------------------------------------------------------------------
------------------------------------------------------------------------------------------------------------------------------------------------------
------------------------------------------------------------------------------------------------------------------------------------------------------
------------------------------------------------------------------------------------------------------------------------------------------------------
------------------------------------------------------------------------------------------------------------------------------------------------------
------------------------------------------------------------------------------------------------------------------------------------------------------
------------------------------------------------------------------------------------------------------------------------------------------------------
------------------------------------------------------------------------------------------------------------------------------------------------------
------------------------------------------------------------------------------%%----------------------------------------------------------------------
--------------------------------------------------------------%%%%%%%%%%-----%|||%-------------------------------%-------------------------------%-%--
------%%%%%----------------------------------------------------|||||||||----|||||||-----------------------------%|%----------------------%---|---|--|%
XXXXXX|||||XXXXXXXXXXXXXX---XXXXXXXXXXXXXX----XXXXXXXXXXX---X-||||||||||--|||||||||-----XXXXXXX----X-XXX---XXX-|||||-----|X-------|-----|||--||--|--||
