------------------------------------------------------------------------------------------------------------------------------------------------------
------------------------------------------------------------------------------------------------------------------------------------------------------
------------------------------------------------------------------------------------------------------------------------------------------------------
------------------------------------------------------------------------------------------------------------------------------------------------------
------------------------------------------------------------------------------------------------------------------------------------------------------
------------------------------------------------------------------------------------------------------------------------------------------------------
------------------------------------------------------------------------------------------------------------------S-----------------------------------
------------------------------------------------------------------------------------------------S-----------------------------g------------g----------
-----------------------------------------------------------------------------------------------------------------------------------------------%g-----
--------------------------------------k--%2C--%%-%-%%%%---%---g-g-------SSS------------gg%%%%%%%-----|||-------%%%%%%%%---------------%%-%%%%%%%|-gg|-
--------------------------------------k------------||||---||-------C-gggg-----------%g||--|||||%%%%%%%%%%%%%%g|||||||||%%%%%%%%%%%%%|%||||||||||||||||
----------------------------------------------||-|||||||--||---------------kggggkgg|||||||||||||||||||||||||||%%%%%|||||||||||||||||||||||||||||||||||
------------------------------------------%|%%%%%%|||||%%-||%----------------------||||||||||||||||||||||||||||||||||||||||||||||||||||||||||||||%%%%k
-------------------------%%%%%%%%%%%%%%%%%%||||||||||||||||||---------------------%%||||||||||||||||||||||||||||||||||||||||||||||||||||||||||||||||||
------%%%%%--------------||||||||||||||||||||||||||||||||||||---------------------||||||||||||||||||||||||||||||||||||||||||||||||||||||||||||||||||||
XXXXXX|||||XXXXXXXXXXXXXX||||||||||||||XX|XX|||||||||||||||||-XXXXXXXXXXXXXXXXXXXXXX||||||||||||||||||||||||||||||||||||||||||||||||||||||||||||||||||
