------------------------------------------------------------------------------------------------------------------------------------------------------
------------------------------------------------------------------------------------------------------------------------------------------------------
------------------------------------------------------------------------------------------------------------------------------------------------------
------------------------------------------------------------------------------------------------------------------------------------------------------
------------------------------------------------------------------------------------------------------------------------------------------------------
------------------------------------------------------------------------------------------------------------------------------------------------------
------------------------------------------------------------------------------------------------------------------------------------------------------
------------------------------------------------------------------------------------------------------------------------------------------------------
------------------------------------------------------------------U------------------------------------------------------------------U---C------------
----------------------------------------------------------------------------------------------g-----g----Sgk-------------g-SSSCCSC--------------------
---------------------------------------------------------------------------%%%%%%%----------------------------------------------------------%%%%%%%%%%
---------------------------------------ggkgkkkgkk------%%%%%%%%%%%%%%%%%%%%%|||||||-%%--ggggggggggggg--------g-------------------------------|||||||||
--------------------------%-%%%%%%%%%%-----------------||||-|||||||||||||||||%%%%%%%%%%%%-----------------------------------------------------||||||||
--------------------------gg-|||||||||-----------------||||-|||||||||||||||||||||||||||||----------------------------------------------------||-||||||
------%%%%%-------------------|||||||-%%%%%%%%S-%-------||--%||||||||||||||||||||||||||||----------------------------------------------------|||||||||
XXXXXX|||||XXXXXXXXXXXXXX---XXXXXXXXXX|||||||||||XXXXXXXX|XX|||||||||||||||||||||||||||||XXXXXXXXXXXXXXXXXXXXXXXXXXXXXXXXXXXXXXXXXXXXXXXXXXXXXXX||||||
