------------------------------------------------------------------------------------------------------------------------------------------------------
------------------------------------------------------------------------------------------------------------------------------------------------------
------------------------------------------------------------------------------------------------------------------------------------------------------
------------------------------------------------------------------------------------------------------------------------------------------------------
------------------------------------------------------------------------------------------------------------------------------------------------------
------------------------------------------------------------------------------------------------------------------------------------------------------
------------------------------------------------------------------------------------------------------------------------------------------------------
------------------------------------------------------------------------------------------------------------------------------------------------------
------------------------------------------------------------------------------------------------------------------------------------------------------
------------------------------------------------------------------------------------------------------------------------------------------------------
---------------------------------------------------------k--------------------------------------------------------------------------------------------
------------------------------------------------------------------------------------------------------------------------------------------------------
-------------------------------------------------------------------%---------%%%%%--------------------------------------------------------------------
--------------------------------------------------------------%%%%%%%%%%%%%%%|||||%------------------------------%%-----------------------------%%%%%%
------%%%%%---------------------------------------------------||||||||||||||||||||||-----------------------------||------------------------------|||||
XXXXXX|||||XXXXXXXXXXXXXX---XXXXXXXXXX---------XXXXXXXXXX-----||||||||||||||||||||||----XXXXXXX------X-----XXXXXX||------XXXX--------------------|||||
