------------------------------------------------------------------------------------------------------------------------------------------------------
------------------------------------------------------------------------------------------------------------------------------------------------------
------------------------------------------------------------------------------------------------------------------------------------------------------
------------------------------------------------------------------------------------------------------------------------------------------------------
------------------------------------------------------------------------------------------------------------------------------------------------------
------------------------------------------------------------------------------------------------------------------------------------------------------
------------------------------------------------------------------------------------------------------------------------------------------------------
------------------------------------------------------------------------------------------------------------------------------------------------------
------------------------------------------------------------------------------------------------------------------------------------------------------
------------------------------------------------------------------------------------------------------------------------------------------------------
------------------------------------------------------------------------------%-----------------------------------------------------------------------
--------------------------------------gggkgkkkgkk-------g-----%%%%%%%%%--gg---||-------------------------------------------------------------------||-
------------------------------%%%%%%--------------------------||||||||||-|||%%%%%%%%%%-------------------------------------------------------------||-
------------------------------|||||||-------------------------||||||||||||||||||||||||-------------------------------------------------------------||-
------%%%%%-------------------|||||||--%%%%%%%S-------------%-||||||||||||||||||||||||-------------------------------------------------------------||%
XXXXXX|||||XXXXXXXXXXXXXX---XXXXXXXXXXX||||||||XXXXXXXXXXXXXXX|||||||||||||||||||||||||-XXXXXXXXXXXXXXXXXXXXXXXXXXXXXXXXXXXXXXXXXXXXXXXXXXXXXXXXXXX|||
