------------------------------------------------------------------------------------------------------------------------------------------------------
------------------------------------------------------------------------------------------------------------------------------------------------------
------------------------------------------------------------------------------------------------------------------------------------------------------
------------------------------------------------------------------------------------------------------------------------------------------------------
------------------------------------------------------------------------------------------------------------------------------------------------------
------------------------------------------------------------------------------------------------------------------------------------------------------
------------------------------------------------------------------------------------------------------------------------------------------------------
------------------------------------------------------------------------------------------------------------------------------------------------------
------------------------------------------------------------------------------------------------------------------------------------------------------
------------------------------------------------------------------------------------------------------------------------------------------------------
-------------------------------------------------------------------------------------------gg------------------------------------%%-%%%%%%%%----------
-----------------------------------g--------------%---------------------------------------------------%%%%--%%-%%%%--------------||--|||||||----------
---------------------------------------------%%---|-----------------------------------------%%%%%-%---||||--||||||||%%%%X%%%%%%%%%%%%%%%|||||---------
---------------------------------------------|-%%%%%%%%%%--%%------------------------------|||||||%%%%%%%%%%||||||||||||||||||||||||||||||||||%-------
------%%%%%------------------------------------|||||||||---||----------------------------|-|||||||||||||||||||||||||||%%%%||||||||||||||||||||%%%%%--%
XXXXXX|||||XXXXXXXXXXXXXX-----XXXXXXXXXXXXXXXXXX|||||||||--||--XXXXXXXXXXXXXXXXXXXXXXXXXX|-|||||||||||||||||||||||||||||||||||||||||||||||||||||||--||
