------------------------------------------------------------------------------------------------------------------------------------------------------
------------------------------------------------------------------------------------------------------------------------------------------------------
------------------------------------------------------------------------------------------------------------------------------------------------------
------------------------------------------------------------------------------------------------------------------------------------------------------
------------------------------------------------------------------------------------------------------------------------------------------------------
------------------------------------------------------------------------------------------------------------------------------------------------------
------------------------------------------------------------------------------------------------------------------------------------------------------
------------------------------------------------------------------------------------------------------------------------------------------------------
------------------------------------------------------------------------------------------------------------------------------------------------------
------------------------------------------------------------------------------------------------------------------------------------------------------
----------------------------------------------------------------------------------------------------------------%-------g---------%---%%%%%%----------
-------------------------------------------------%%----------g--------g-----------------------|---|----%|g-----|||-------|--------|---|||||||---------
---------------------------------------------%--|||-------------------------------------------|---||---|||---|||||||----|||--||--||--||||||||---------
--------------------------------------------||--|||%%%%----------%%------------%---------|---|||--||%%%||%%-|||||||||--||||--||--|||||||||||||--------
------%%%%%-------------------|||---|-----------|||||||----------||------------|---------|--||||-||||||||||||||||||%%%%%|||-||||-|||%||||||||||------%
XXXXXX|||||XXXXXXXXXXXXXX---|X|||||XXXXXXXXXXXXXXXXXXXXX--XXXXXXXXXXXXXXXXXXXXXXXXXXXXXXXX-X||||||||||||||||||||||||||||||||||||||||||||||||||||||-X||
