------------------------------------------------------------------------------------------------------------------------------------------------------
------------------------------------------------------------------------------------------------------------------------------------------------------
------------------------------------------------------------------------------------------------------------------------------------------------------
------------------------------------------------------------------------------------------------------------------------------------------------------
------------------------------------------------------------------------------------------------------------------------------------------------------
------------------------------------------------------------------------------------------------------------------------------------------------------
------------------------------------------------------------------------------------------------------------------------------------------------------
------------------------------------------------------------------------------------------------------------------------------------------------------
------------------------------------------------------------------------------------------------------------------------------------------------------
------------------------------------------------------------------------------------------------------------------------------------------------------
----------------------------------------------------------------------------------------------------------------------------------------------%%%%%%%%
------------------------------------------------------------------------------------------g-g-------------------------------------------------||||||||
--------------------------------%--%------------------------%%%%%%%-%%%%%%%%%%--%%%%%%-------------------------------------------------------|||||||||
--------------------------------|||||------------------%%%%-|||||||%|||||||||---||||||%%%------%%%-----------------------%%%%%%%%%%%-%%%%%%%%%||||||||
------%%%%%---------------------|||||-------%%S|%%----%|||||%||||||||||||||||%%%%%|||||||-------||--%--%%%%-%-------------||||--|||--||-||||||||||||||
XXXXXX|||||XXXXXXXXXXXXXX----XXXXXXXXXX----||||||||--||||||||||||||||||||||||||||||||||||-----XX||--|---|||----------XXXXXXX||--|||--|||-|||||||||||||
