------------------------------------------------------------------------------------------------------------------------------------------------------
------------------------------------------------------------------------------------------------------------------------------------------------------
------------------------------------------------------------------------------------------------------------------------------------------------------
------------------------------------------------------------------------------------------------------------------------------------------------------
------------------------------------------------------------------------------------------------------------------------------------------------------
------------------------------------------------------------------------------------------------------------------------------------------------------
-----------------------------------------------------------------------------------------------------------------CSS--------------------------------C-
------------------------------------------------------------------------------------------------S--------------------------X---------------g----------
-----------------------------------------------------------------------------------g--------------------------------------------------------k---g-----
--------------------------------------USCSCCSC%C-%---%%---gC--g-g-----SSSS------------%ggk%%%------------------%%%%%%%-----------------%--%%%%%%%-gg--
--------------------------g---------g-k-------------|||---||---------gg-g------------g-----||--%%%%%%%%%%%%%---|||||||%%%%%%%%%%%%%%%%%|%||||||||--||-
---------------------------------------------------|||----------------------gggg--g--------%%%%|||||||||%%%%%%%%%%%%|||||||||||||||||||||||||-|||-----
--------------------------------------------%%%%%%%%%%%%--%%-------------------------|%%%%%|||||||||||||||||||||||||||||||||||||||||||||||||%%%%%%%%%k
-------------------------%%%%%%%%%%-%%%%%%%|||||||||||||--||-----------------------%%|||||||||||||||||||||||||||||||||||||||||||||||||||||||||||||||||
------%%%%%--------------|||||||||||||||||||||||||||||||--||-----------------------|||||||||||||||||||||||||||||||||||||||||||||||||||||||||||||||||||
XXXXXX|||||XXXXXXXXXXXXXX|||||||||||X||XXXXXXXX|||||||||--||---XXXXXXXXXXXXXXXXXXXXXX|||||||||||||||||||||||||||||||||||||||||||||||||||||||||||||||||
