------------------------------------------------------------------------------------------------------------------------------------------------------
------------------------------------------------------------------------------------------------------------------------------------------------------
------------------------------------------------------------------------------------------------------------------------------------------------------
------------------------------------------------------------------------------------------------------------------------------------------------------
------------------------------------------------------------------------------------------------------------------------------------------------------
------------------------------------------------------------------------------------------------------------------------------------------------------
------------------------------------------------------------------------------------------------------------------------------------------------------
------------------------------------------------------------------------------------------------------------------------------------------------------
------------------------------------------------------------------------------------------------------------------------------------------------------
------------------------------------------------------------------------------------------------------------------------------------------------------
----------------------------------------------------------------------%------------------------------------------------------------------------%%%%%%%
---------------------------------------gkkkkk-gg----------------|---||||-|%%%|---|%%%%%--gg---------------------------------g-------------------||||||
-----------------------------%%%%%%%%%%------------------%|---%%%%%%%%|%%|||||%%%%%%||||--------------------------------------------------------||||||
-----------------------------||||||||||------------------||--||||||||||||||||||||||||||||------------------------------------------------------|||||||
------%%%%%-------------------||||||||%%%%%%%%||---------||--||||||||||||||||||||||||||||------------------------------------------------------|||||||
XXXXXX|||||XXXXXXXXXXXXXX||-XXXXXXXXX|||||||||||XXXXXXXXXXX-X||||||||||||||||||||||||||||XXXXXXXXXXXXXXXXXXXXXXXXXXXXXXXXXXXXXXXXXXXXXXXXXXXXXXX||||||
