------------------------------------------------------------------------------------------------------------------------------------------------------
------------------------------------------------------------------------------------------------------------------------------------------------------
------------------------------------------------------------------------------------------------------------------------------------------------------
------------------------------------------------------------------------------------------------------------------------------------------------------
------------------------------------------------------------------------------------------------------------------------------------U-----------------
------------------------------------------------------------------------------------------------------------------------------------------------------
-----------------------------------------------------------------------------------------------------------%gS---%S%-C2--------------|-|%-----------|-
---------------------------------------------------------------------------------------|------------%%%%------------------%%%%g-|-----|----g|---|---|-
----------------------------------------------------------g--g---------------%--%--%---|----|-------|-|||----------|------|||-|||--|---|--|-||||g--||-
--------------------------------------k%k%%ggg%%-|-%%%||--%|--%%g%%%%%SS-%g------||||-||g%%%%%%%%%%%|||||--||%-%%%%%%%%gg-|||||||-|||-%%%%|||||||-g||-
------------------------------------k||--||||-----||||||--||-------C|gggg||-------|||||||||||||||%%||||||%%||||||||||||%%%%%%%%||%||||||||||||||||||||
---------------------------------%---||-||||--||||||||||k||k------------|--kggkgkgg||||||||||||||||||||||||||||||||||||||||||||||||||||||||||||||-|--|
--------------------------------------|-||||%%||||||||||--||------------|---------||||||||||||||||||||||||||||||||||||||||||||||||||||||||||||||%-%--|
-------------------------%%%%%%%%%%%%%%%%|||||||||||||||--||------------|--------%|||||||||||||||||||||||||||||||||||||||||||||||||||||||||||||||-|--|
------%%%%%--------------|||||||||||||||||||||||||||||||--|||-----------|--|-----||||||||||||||||||||||||||||||||||||||||||||||||||||||||||||||||----|
XXXXXX|||||XXXXXXXXXXXXXX|||||||||||||||||||||||||||||||XXXXXXXXXXXXXXXXXXXXXXXXXXXXX||||||||||||||||||||||||||||||||||||||||||||||||||||||||||||XXXXX
