------------------------------------------------------------------------------------------------------------------------------------------------------
------------------------------------------------------------------------------------------------------------------------------------------------------
------------------------------------------------------------------------------------------------------------------------------------------------------
------------------------------------------------------------------------------------------------------------------------------------------------------
------------------------------------------------------------------------------------------------------------------------------------------------------
------------------------------------------------------------------------------------------------------------------------------------------------------
------------------------------------------------------------------------------------------------------------------------------------------------------
------------------------------------------------------------------------------------------------------------------------------------------------------
------------------------------------------------------------------------------------------------------------------------------------------------------
------------------------------------------------------------------------------------------------------------------------------------------------------
------------------------------------------------------------------------------------------------------------------------------------------------------
-------------------------------------------------------------------------------------------------------------------------------------------------%%%%-
-------------------------------%%----------------------------------------------%%%--------------------------------------------------------------||||||
--------------------------------|--|-------------%----%%%%---%%%%%%%%%%%%%%%---|||--------------------------------------------------------%%%%%%%|||||
------%%%%%------------------------||--------%S|||----||||--%||||||||||||||||%%%%%%%%%%----------------------------------|---|----|---|--||||||||||||%
XXXXXX|||||XXXXXXXXXXXXXX---XXXXXXXXXXX--X---||||XXXXX||||--|||||||||||||||||||||||||||-----XXXXX-------------XXXX----XXX|XXX|----|---|--|||||||||||||
