------------------------------------------------------------------------------------------------------------------------------------------------------
------------------------------------------------------------------------------------------------------------------------------------------------------
------------------------------------------------------------------------------------------------------------------------------------------------------
------------------------------------------------------------------------------------------------------------------------------------------------------
------------------------------------------------------------------------------------------------------------------------------------------------------
------------------------------------------------------------------------------------------------------------------------------------------------------
------------------------------------------------------------------------------------------------------------------------------------------------------
------------------------------------------------------------------------------------------------------------------------------------------------------
------------------------------------------------------------------------------------------------------------------------------------------------------
------------------------------------------------------------------------------------------------------------------------------------------------------
------------------------------------------------------------------------------------------------------------------------------------------------------
------------------------------------ggggg-g-gk------------------%%%%%-----g----%----------------------------------------------------------------------
--------------------------------%%%-----------------------------|||||--------%%%%%%-------------------------------------------------------------------
--------------------------------||----------------------------%%%%%%%%%%%%%%|||||||-------------------------------------------------------------------
------%%%%%---------------------|-----------------------------||||||||||-||||||||||------------------------------|------------------------------------
XXXXXX|||||XXXXXXXXXXXXXX---XXXXXXXXXXXXXX-----XXXXXXXXXXX-XXX||||||||||-|||||||||||---XXXXXXXXXXXXXXXXXXXXXXXXXX|XX----XXXXXXX---XXX--XXXXXXX--------
