------------------------------------------------------------------------------------------------------------------------------------------------------
------------------------------------------------------------------------------------------------------------------------------------------------------
------------------------------------------------------------------------------------------------------------------------------------------------------
------------------------------------------------------------------------------------------------------------------------------------------------------
------------------------------------------------------------------------------------------------------------------------------------------------------
------------------------------------------------------------------------------------------------------------------------------------------------------
------------------------------------------------------------------------------------------------------------------------------------------------------
----------------------------------------------------------------------------------------------------------------------------------------r-------------
-------------------------------------------------------------g--------------------------------------------------g-------------|-------------k-g-------
--------------------------------------CSCCSCkgk------------------g--------------------g-gg-g--------------------------------------------------S-------
----------------------------------------------------------------------------------------||-%%%g%%%%%%%%%%%%%%%%%%%%%%%%%%%%%%%%%%%%%%%%%%%%%%---------
-------------------------------%%--gk-----------%%%%%%%-----ggg---------------ggggggkg--|---||||-||||||||||||||||||||||||||||||||||||||||||||---------
---------------------------------------%%%%-%%%%|||||||---------------------------------%%%%%%%%%%|||||||||||||||||||||||||||||||||||||||||||---------
-------------------------%%%%---------g||||||||||||||||---------------------------------|||||||||||||||||||||||||||||||||||||||||||||||||||||---------
------%%%%%--------------|||X||%%Xk%---||||||||||||||||----------------------------------||||||||||||||||||||||||||||||||||||||||||||||||||||%%%------
XXXXXX|||||XXXXXXXXXXXXXX||||||||||||XXXXXXXXXXXXX||||X---XXXXXXXXXXXXXXXXXXXXXXXXXXXXXXXX||||||||||||||||||||||||||||||||||||||||||||||||||||||XXXXXX
