------------------------------------------------------------------------------------------------------------------------------------------------------
------------------------------------------------------------------------------------------------------------------------------------------------------
------------------------------------------------------------------------------------------------------------------------------------------------------
------------------------------------------------------------------------------------------------------------------------------------------------------
------------------------------------------------------------------------------------------------------------------------------------------------------
------------------------------------------------------------------------------------------------------------------------------------------------------
------------------------------------------------------------------------------------------------------%%---CkSS----%----------------------------------
------------------------------------------------------------------------------------------------------|-------------%%%%---%%%g-%%%%%%%---%%%--%---%|-
---------------------------------------------S---%-----S--g-gg-----------%--g%-----%-%%%-%%%%%--------------%%%-%%-||--||||||-|||-|||-||--|-|||gg--||-
--------------------------g-----------ggggggggk----------------%%%%%%----|--------|||-g|ggS|||-%%%%%%%%%%--%||-||||||--||--||||||-|||-||--||||-|---gg-
---------------------------------------------------------------|g||||ggggg--------|||||||||||||ggg|||||||%%|||||||%%%%%%%%%%%%%%%%%%%%||%%|||--|------
-------------------------------%%%%--kk--||g--%%%%%%%%kgkgkkg---k-C||-----kkggkggggg%%%%%|||||||||||||||||||||||||||||||||||||||||||||||||------------
--------------------------------|||---|%%%%|%%|||||||||------------|-------||||-|||||||||||||%||||||||||||||||||||||||||||||||||||||||||||-2----------
-------------------------%%%%%%%%%%%%%%|||||||||||||||-------------|-------||||%%||||||||||||||||||||||||||||||||||||||||||||-|||--||||||---|---------
------%%%%%--------------|||||||||||||||||||||||||||||---------------------|||||||||||||||||||||-|||||||||||||||||||||||||||--||||-|||||||-|----------
XXXXXX|||||XXXXXXXXXXXXXX|||||||||||||||XXXXXXXXXXXXXXXXXXXXXXXXXXXXXXXXXXXXXXXXXXXXXXXXXXX||||-XX|XX|||||||||||||||||||||-|-XXXXXXXXXX|XXXXXXXXXXXXXX
