------------------------------------------------------------------------------------------------------------------------------------------------------
------------------------------------------------------------------------------------------------------------------------------------------------------
------------------------------------------------------------------------------------------------------------------------------------------------------
------------------------------------------------------------------------------------------------------------------------------------------------------
------------------------------------------------------------------------------------------------------------------------------------------------------
------------------------------------------------------------------------------------------------------------------------------------------------------
------------------------------------------------------------------------------------------------------------------------------------------------------
------------------------------------------------------------------------------------------------------------------------------------------------------
--------------------------------------------------------------------------------------------------------------------------r---------------------------
-------------------------------------------------------------------------------------------------------------S----------------------------------------
----------------------------------------------------------------%%%%%%----%%-----------------------------------------------------------------------%--
---------------------------------%%--gggggkgkgggg---------------||||||---|||%%%%%%%%%%%---------------------------g-g---------------------------------
--------------------------g-%%%%%%%%---------------------------||||||||--%|||||||||||||------------------------------------------------------------|--
----------------------------||||||||---------------------------||||||||-|||||||||||||||------------------------------------------------------------|--
------%%%%%--------------%%|||||||||-%%%%%%%%------------------||||||||-|||||||||||||||------------------------------------------------------------|--
XXXXXX|||||XXXXXXXXXXXXXX||||||||||X|||||||||XXXXXXXXXXXXXXXXXX||||||||-|||||||||||||||XXXXXXXXXXXXXXXXXXXXXXXXXXXXXXXXXXXXXXXXXXXXXXXXXXXXXXXXXXXXXXX
