------------------------------------------------------------------------------------------------------------------------------------------------------
------------------------------------------------------------------------------------------------------------------------------------------------------
------------------------------------------------------------------------------------------------------------------------------------------------------
------------------------------------------------------------------------------------------------------------------------------------------------------
------------------------------------------------------------------------------------------------------------------------------------------------------
------------------------------------------------------------------------------------------------------------------------------------------------------
------------------------------------------------------------------------------------------------------------------------------------------------------
------------------------------------------------------------------------------------------------------------------------------------------------------
------------------------------------------------------------------------------------------------------------------------------------------------------
------------------------------------------------------------------------------------------------------------------------------------------------------
------------------------------------------------------------------------------------------------------------------------------------------------------
--------------------------------------------------------------------------------------ggg---g--------------------------------------------%%%%%%%%%%%%%
-----------------------------------------------------------------------------------------------------------------------------------------|||||||||||||
---------------------------------------------%%%%%%%%%%%%%%%%%%%%%%%%%%%%%%-------------%%---%%%%%%%%%--%----------------%%%%%%%%%%-%%%%%%%%%%%|%%||||
------%%%%%----------------------------------||||||||||||||||||||||||||||||---%%%%%%%%%-||---|||||||||-%%%%-%%%%%%%---%%%||||||||||%||||||||||||||||||
XXXXXX|||||XXXXXXXXXXXXXX---XXXXXXXXXXXXXXX--||||||||||||||||||||||||||||||---||||||||||||---||||||||--|||--||||||----||||||||||||||||||||||||||||||||
