------------------------------------------------------------------------------------------------------------------------------------------------------
------------------------------------------------------------------------------------------------------------------------------------------------------
------------------------------------------------------------------------------------------------------------------------------------------------------
------------------------------------------------------------------------------------------------------------------------------------------------------
------------------------------------------------------------------------------------------------------------------------------------------------------
------------------------------------------------------------------------------------------------------------------------------------------------------
------------------------------------------------------------------------------------------------------------------------------------------------------
------------------------------------------------------------------------------------------------------------------------------------------------------
------------------------------------------------------------------------------------------------------------------------------------------------------
------------------------------------------------------------------------------------------------------------------------------------------------------
------------------------------------------------------------------------------------------------------------------------------------------------------
------------------------------------------------------------------------------------------------------------------------------------------------------
------------------------------------------------------------------------------------------------------------------------------------------------------
---------------------------------------------------%-----------------------%%%%%%%%%%%%----%-----------|--%%%%%%%%%%%%%%%----------|%-----------%%%%%%
------%%%%%----------------------------------------||------------%%%%%%%%%%||||||||||||----|%%%%%%%%%%%|--||||||||||||||||%|%%%||-|||-||%%%%%%%%||||||
XXXXXX|||||XXXXXXXXXXXXXX-----XXXXXXXXXXX--XXXXXXXX||-----------|||||||-|||||||||||||||X--|||||||||||||||||||||||||||||||||||||||||||-||||||||||||||||
