------------------------------------------------------------------------------------------------------------------------------------------------------
------------------------------------------------------------------------------------------------------------------------------------------------------
------------------------------------------------------------------------------------------------------------------------------------------------------
------------------------------------------------------------------------------------------------------------------------------------------------------
------------------------------------------------------------------------------------------------------------------------------------------------------
------------------------------------------------------------------------------------------------------------------------------------------------------
------------------------------------------------------------------------------------------------------------------------------------------------------
------------------------------------------------------------------------------------------------------------------------------------------------------
------------------------------------------------------------------------------------------------------------------------------------------------------
------------------------------------------------------------------------------------------------------------------------------------------------------
----------------------------------g----------------------k--------------------------------------------------------------------------------------------
-------------------------------------gggggkg-gg-------------------------------%----%------------------------------g-----------------------------------
--------------------------g-----%%%-----------------------------%%%%%%%---%%%%%%%%%||-----------------------------------------------------------------
--------------------------------|||-----------------------------|||||||--||||||||||||----------------------------%%%-------------------------------%--
------%%%%%---------------------|||--%%%-----------------------||||||||--|||||||||||||---------------------------|||-------------------------------|--
XXXXXX|||||XXXXXXXXXXXXXX---XXXXXXXXX|||---X--XXXXXXXXXXXXXXXXX||||||||--||||||||||||--XXXXXXXXXXXXXXXXXXXXXXXXXXX|X-----XXXXXXXXXXXXXXXXXXXX------|--
