------------------------------------------------------------------------------------------------------------------------------------------------------
------------------------------------------------------------------------------------------------------------------------------------------------------
------------------------------------------------------------------------------------------------------------------------------------------------------
------------------------------------------------------------------------------------------------------------------------------------------------------
------------------------------------------------------------------------------------------------------------------------------------------------------
------------------------------------------------------------------------------------------------------------------------------------------------------
------------------------------------------------------------------------------------------------------------------------------------------------------
------------------------------------------------------------------------------------------------------------------------------------------------------
-------------------------------------------------------------------------------------------r---------------------------g----------g-------------------
------------------------------------------------------------------------------------------------------S-----------------------------------------------
----------------------------------g-------------------------------g%--------------------------------------------%%%%%%--------------------------------
---------------------------------%%-gggkggggggkggkgg--------------||--------%%%%%%%%%%------------------g-g----|||||||g-------------------------------
-----------------------------------------%-----------------------%%%%------|||||||||---------------------------||||||||-------------------------------
-----------------------------------------------------------------||||------|||||%%%%%-------------------------|||||||||-------------------------------
------%%%%%--------------%%|X|-%%|k%-%%--------------------------||||------||||||||||--------------------------|||||||--------------------------------
XXXXXX|||||XXXXXXXXXXXXXX||||||||||||||XX-XXXXXXXXXXXXXXXXXXXXXXXX|||-----X||||||||XXXXXXXXXXX--XXXXXXXXXXXXXXX|||||||-------XXXXXXXXXXXXXXXXXXXX-XXXX
