------------------------------------------------------------------------------------------------------------------------------------------------------
------------------------------------------------------------------------------------------------------------------------------------------------------
------------------------------------------------------------------------------------------------------------------------------------------------------
------------------------------------------------------------------------------------------------------------------------------------------------------
------------------------------------------------------------------------------------------------------------------------------------------------------
------------------------------------------------------------------------------------------------------------------------------------------------------
------------------------------------------------------------------------------------------------------------------------------------------------------
------------------------------------------------------------------------------------------------------------------------------------------------------
------------------------------------------------------------------------------------------------------------------------------------------------------
------------------------------------------------------------------------------------------------------------------------------------------------------
-----------------------------------------------------------g-------------------------------gg----------------------------------------%-%%%%%----------
--------------------------------------------------------------g----------------------------------------%%--------k-------------------|--||||%%%-------
----------------------------------------------------------------------------------------------%%--------|------%%|%-%%%%X%%%%%%%%%%%%%%%%||||||-------
---------------------------------------------|-%%%%%%%%%%%%%%%%%%%%---%---------------------%%%|%%%%%%%%%%%%%||||||-----||||||||||||||||||||||%%------
------%%%%%------------------------------------||||||||||--||||||||----------------------|--||||||||||||||||||||||%%%%%%%%%%||||||||||||||||||||%%%-|%
XXXXXX|||||XXXXXXXXXXXXXX---X-XXXXXXXXXXXXXX-X|||||||||||--|||||XX---XXX-----XXXXXXXXXXXX|--||||||||||||||||||||||||||||||||||||||||||||||||||||||--||
