------------------------------------------------------------------------------------------------------------------------------------------------------
------------------------------------------------------------------------------------------------------------------------------------------------------
------------------------------------------------------------------------------------------------------------------------------------------------------
------------------------------------------------------------------------------------------------------------------------------------------------------
------------------------------------------------------------------------------------------------------------------------------------------------------
------------------------------------------------------------------------------------------------------------------------------------------------------
------------------------------------------------------------------------------------------------------------------------------------------------------
------------------------------------------------------------------------------------------------------------------------------------------------------
------------------------------------------------------------------------------------------------------------------------------------------------------
------------------------------------------------------------------------------------------------------------------------------------------------------
------------------------------------------------------------------------------------------------------------------------------------------------------
------------------------------------------------------------------------------------------------------------------------------------------------------
------------------------------------------------------------------------------------------------------------------------------------------------------
--------------------------------------------------------------%%%%%%%%%%%%%%%%%%%-------------------------------%%%%---------------------%%%%%%%%%%%%%
------%%%%%---------------------------------------------|-----|||||||||||||||||||||-----------------------------||||-----%%%%%%----%%---||||||||||||||
XXXXXX|||||XXXXXXXXXXXXXX----XXXXXXXXXXXXX----XXXXXXX--||-----||||||||||||||||||||||-----------|---------------||||||----|||||----|-----||||||||||||||
