------------------------------------------------------------------------------------------------------------------------------------------------------
------------------------------------------------------------------------------------------------------------------------------------------------------
------------------------------------------------------------------------------------------------------------------------------------------------------
------------------------------------------------------------------------------------------------------------------------------------------------------
------------------------------------------------------------------------------------------------------------------------------------------------------
------------------------------------------------------------------------------------------------------------------------------------------------------
------------------------------------------------------------------------------------------------------------------------------------------------------
------------------------------------------------------------------------------------------------------------------------------------------------------
--------------------------------------------------------------------------------------------------------------------------------------------k---------
--------------------------------------gCSC--------------------------------------------g--gSg----------------------------------------------------------
------------------------------------------------------------------g----------------------------g-g-r-%%%------%%%%%%%%%%%%%%--%%%--%%--%%%------------
---------------------------------%-g-k------------g%%-----------------------ggggggggkg---------------|||g%%%%%||||||||||||-|--g|---||--|g-------------
----------------------------------------%%%-%---%%|%%------------------------------------%%%%%%%--%%%%||||||||||||||||||||-|--|||--||--|||------------
-------------------------%%%%%--------g--||||---|||||-----------------------%%%%%%-------||||||---||||||||||||||||||||||||-|--|||--||--||-------------
------%%%%%--------------%%||||%%Xk%-------------||||------------------------|||||--------|||%%%--||||||||||||||||||||||||-|--|||--||--|%%%%%---------
XXXXXX|||||XXXXXXXXXXXXXX|||||||||||||XXXXXXXXXXXXXXXXX--XXXXXXXXXXXXXXXXXXXXXXXXXXXXXXXXXX|||||-|||X|||||||||||||||||||||||--|||XX||-||||||XXXXXXXXXX
