------------------------------------------------------------------------------------------------------------------------------------------------------
------------------------------------------------------------------------------------------------------------------------------------------------------
------------------------------------------------------------------------------------------------------------------------------------------------------
------------------------------------------------------------------------------------------------------------------------------------------------------
------------------------------------------------------------------------------------------------------------------------------------------------------
------------------------------------------------------------------------------------------------------------------------------------------------------
------------------------------------------------------------------------------------------------------------------------------------------------------
------------------------------------------------------------------------------------------------------------------------------------------------------
------------------------------------------------------------------------------------------------------------------------------------------------------
-----------------------------------------------------CCSSSSSgS---------------------------------------------------------------------------------%%%%%%%
--------------------------------------------Sg------------ggg-----------------------------------------------------------------------------------||--||
--------------------------------------------------------------------------------------------%%%%%%%%%%%%----------------%-||%%%%%%%%%%%%%%%%%%%%%%%%%%
------------------------------------------------%%%%%%%%-------------------------------------||||||||||%%%%%%%%%%-%-%%%%F%||||||||||||||||||||||||||||
-------------------------------------%-----%%%%%%|||||||%%%%%%%---------------------%%%%%%%%%|||||||||||||||||||||||||||||||||||||||||||||||||||||||||
------%%%%%--------------------------|------|||||||||||||||||||-------%%%%----------|||||||||||||||||||||||||||||%%|||||||||||||||||||||||||||||||||||
XXXXXX|||||XXXXXXXXXXXXXX-----XXXXXXXXXXXXXX|||||||||||||||||||-----XX||||-----XXXX-||||||||||||||||||||||||||||||||||||||||||||||||||||||||||||||||||
