------------------------------------------------------------------------------------------------------------------------------------------------------
------------------------------------------------------------------------------------------------------------------------------------------------------
------------------------------------------------------------------------------------------------------------------------------------------------------
------------------------------------------------------------------------------------------------------------------------------------------------------
------------------------------------------------------------------------------------------------------------------------------------------------------
------------------------------------------------------------------------------------------------------------------------------------------------------
------------------------------------------------------------------------------------------------------------------------------------------------------
------------------------------------------------------------------------------------------------------------------------------------------------------
------------------------------------------------------------------------------------------------------------------------------------------------------
--------------------------------------S-----------------------------------------------------------------------------------------------------g---------
--------------------------------------------------------------------------------------------------------------------------------%---------------------
--------------------------------------------------------------------------------------------------------%%%%%%%%%%%%%%k%------------------------------
-------------------------------------------------%%%--------------------------------------%%%%%%%%%%%%%%%|||||||||||||||F%%%%%%%%%%%%%%%%-%2%%%-------
-------------------------------------------------|||%%-----------------------%%-----------|||||||||||||||||||||||||||||||||||||||||||||||||||---------
------%%%%%--------------------------------------|||||-----------------------||----------||||||%%|||||||||||||||||||||||||||||||||||||||%%%%%%%%%%%---
XXXXXX|||||XXXXXXXXXXXXXX-----XXXXXXXXXXXXXXXXXXXX||||---------XXXXX----X-XXX|X--XXXXXXXX|||||||||||||||||||||||||||||||||||||||||||||||||||||||||||--
