------------------------------------------------------------------------------------------------------------------------------------------------------
------------------------------------------------------------------------------------------------------------------------------------------------------
------------------------------------------------------------------------------------------------------------------------------------------------------
------------------------------------------------------------------------------------------------------------------------------------------------------
------------------------------------------------------------------------------------------------------------------------------------------------------
------------------------------------------------------------------------------------------------------------------------------------------------------
------------------------------------------------------------------------------------------------------------------------------------------------------
------------------------------------------------------------------------------------------------------------------------------------------------------
------------------------------------------------------------------------------------------------------------------------------------------------------
-----------------------------------------------------C---SgC--g----------S-------------g---------------------------------------------------%%%%%%%-%%-
--------------------------------------------------------------------------------------------------------------------------%%%%%%%%%%%------||||||--||-
-------------------------------------------------------------------------------------------%%%%%||%%%%%%%%%%%%%%%%%%%%k%%|||||||||||%%%%%%%%---||-----
----------------------------------------------%%%%%%%%%%%-%%--------------------------%%%%%%||||||%%%%%|||||||||||||||||||||||||||||||||||%2%%%%%%%%%k
------------------------------%%%-%--%%---%%%%||||||||||-|||----------------------%%%%||||||||||||||||||||||||||||||||||||||||||||||||||||||||||||||||
------%%%%%-------------------|||----||---||||||||||||||-%||-----------%%%%-------||||||||||||||||||||||||||||||||||||||||||||||||||||||||||||||||||||
XXXXXX|||||XXXXXXXXXXXXXX-----|||XXXXXXXXXXXXX||||||||||||||------XXXXX||||XXX-XXXX|||||||||||||||||||||||||||||||||||||||||||||||||||||||||||||||||||
