------------------------------------------------------------------------------------------------------------------------------------------------------
------------------------------------------------------------------------------------------------------------------------------------------------------
------------------------------------------------------------------------------------------------------------------------------------------------------
------------------------------------------------------------------------------------------------------------------------------------------------------
------------------------------------------------------------------------------------------------------------------------------------------------------
------------------------------------------------------------------------------------------------------------------------------------------------------
------------------------------------------------------------------------------------------------------------------------------------------------------
------------------------------------------------------------------------------------------------------------------------------------------------------
------------------------------------------------------------------U------------------------------------------------------------------U----------------
---------------------------------------------------------------------------------------------------------Sg-----------C----SSSCCS-------g-------------
------------------------------------------k---------------------------------%%%%%%%--------------------------------------g-----------------%%%%%%%%%%%
---------------------------------------ggkgkkkgkk------%%%%%%%%%%%%%%%%%%%%%%--||||----gggggggggggggg--------g-------------------g---g-----|||||||||||
-----------------------------%%%%%%%%%-----------------||||||||||||||||||||||%%%%%%%%%%%%----------------------------------------------------|||||||||
--------------------------gg--||||||||-----------------||||-|||||||||||||||||||||||||||||----------------------------------------------------|||||||||
------%%%%%-------------------||||||||-%%%%%%%S|%------||||-%||||||||||||||||||||||||||||-------------------------------------------------|--|||||||||
XXXXXX|||||XXXXXXXXXXXXXX---XXXXXXXXXX||||||||||||XXXXX||||||||||||||||||||||||||||||||||-XXXXXXXXXXXXXXXXXXXXXXXXXXXXXXXXXXXXXXXXXXXXXXXXXXX|||||||||
