------------------------------------------------------------------------------------------------------------------------------------------------------
------------------------------------------------------------------------------------------------------------------------------------------------------
------------------------------------------------------------------------------------------------------------------------------------------------------
------------------------------------------------------------------------------------------------------------------------------------------------------
------------------------------------------------------------------------------------2--------------%--%----------------SS-%-%------%U-----------------
--------------------------------------------------------------------------------------------C------2--------------------------------------g------S----
------------------------------------------S-------------------------%%-%---|%%U------%--%------------------%gS---%S%SC2--------%%-%k-|-%%CC|--------|-
--------------------------------------------------------------------------------------||--------%%%-%%%%|%%---------||||-%%%%%g-|-||--|-|--|------r%|-
-------------------------------------------------%---%-%--g%-%%|-------------%-%%--g-%||-||----||||||-||||-||---g|-|----|||||-|||-%|%--||-|-%%%%%%|||%
------------------------------|-------kgk%ggg%%%-||%%%||%-%|-|||gg%g%gSSS%g-----|||||-|%%%%%%%%-||||||||||-|||-%%%%%%%%%||||||||||||||%||%||||||||||||
---------------------------g--------kk||g||||-----||||||--||-|-----C--g||||-------||||||||||||%%%%%%%%%%%%%%%%%||||||||||%%%%|||||||||||||||||||||||||
------------------------------%%%%-U||||||||||||%%||||||||||g|kkk-gkgg--|kkkggggkgkg|||||||||||||||||||||||||||||||||||||||||||||||||||||||||||||----|
-------------------------------||---|--|||||||%|||||||||||||||----------|----------||||||||||||||||||||||||||||||||||||||||||||||||||||||||||||||----|
-------------------------%%%%%%%%%%%%%%%|||||||||||||||||-||||---------------------||||||||||||||||||||||||||||||||||||||||||||||||||||||||||||||----|
------%%%%%--------------||||||||||||||||||||||||||||||||-||||----------------------|||||||||||||||||||||||||||||||||||||||||||||||||||||||||||||----|
XXXXXX|||||XXXXXXXXXXXXXX|||||||||||||||XXX|||||||||||||XXXXXXXXXXXXXXXXXXXXXXXXXXXXXX||||||||||||||||||||||||||||||||||||||||||||||||||||||||||XXXXXX
