------------------------------------------------------------------------------------------------------------------------------------------------------
------------------------------------------------------------------------------------------------------------------------------------------------------
------------------------------------------------------------------------------------------------------------------------------------------------------
------------------------------------------------------------------------------------------------------------------------------------------------------
------------------------------------------------------------------------------------------------------------------------------------------------------
------------------------------------------------------------------------------------------------------------------------------------------------------
------------------------------------------------------------------------------------------------------------------------------------------------------
------------------------------------------------------------------------------------------------------------------------------------------------------
------------------------------------------------------------------------------------------------------------------------------------------------------
------------------------------------------------------------------------------------------------------------------------------------------------------
---------------------------------------------g------------ggg-----------------------------------------------------------------------------------------
-------------------------------------------------------------------------------------------------------%---------------------%%--%%%%%%%%%%%%%%%%-----
----------------------------------------------------------------------------------------------|%--|----||%%%%%%%%|%-%%%%F%%%%%%%%%%%%|||||||||||||---|
----------------------------------------------%%%%%%%%%%%%%%%%%%-----------------------%%%%%%%|%%%%%%%%%%||||||||||||||||||||||||||||||||||||||||||%||
------%%%%%----------------------------------||||||||||||||||||--------%---------------|||||||||||||||||||||||||||||||||||||||||||||||||||||||||||||||
XXXXXX|||||XXXXXXXXXXXXXX-----XXXXXXXXXXXXXXX||||||||||||||||||------X||------XXXXX-X-||||||||||||||||||||||||||||||||||||||||||||||||||||||||||||||||
