------------------------------------------------------------------------------------------------------------------------------------------------------
------------------------------------------------------------------------------------------------------------------------------------------------------
------------------------------------------------------------------------------------------------------------------------------------------------------
------------------------------------------------------------------------------------------------------------------------------------------------------
------------------------------------------------------------------------------------------------------------------------------------------------------
------------------------------------------------------------------------------------------------------------------------------------------------------
-------------------------------------------------------------------------------------------------------%---C------------------------------------------
--------------------------------------------------------------------------------------------------------------------%-%%-----%g--%%%%%%-r------%---r--
---------------------------------------------S---------S--g-g------------%SSg%-%-----%%%-%%%%%%-------------%%%-%%|||-|||||%|%|||-|||||||-|-|ggg--||-|
--------------------------g------------gggggggk----------------%%%%%%-----|----||%|||-|-|||||||---%%%%%%%%--||-||||||-|||||||||||||||||||-||||||---|--
---------------------------------------------------------------|||||||--g||---||||||||||||||||||g|||||||||%%||||%|%%%%%%%%%%|||||||||%%%%%%||--|------
-------------------------%-%%%%%%%%%%%%%||%gg%%%%%%%%%%kkgkkgkkkk||||gggg|kgkgk%g%%%%%|||||||||||||||||||||||||||||||||||||||||||||||||||||||---------
-------------------------||||||||||||||||||||||||||||||----|------|||------||||||||||||||||||||||||||||||||||||||||||||||||||||||||||||||||||---------
-------------------------||||||||||||-%||||||||||||||||----|-------|--------||||||||||||||||||||||||||||||||||||||||||||||||-|||||-|||-|||-|----------
------%%%%%--------------||||||||||||||||||||||||||||||------------||--------|||||||||||||||||||-|||||||||||||||||||||||||||--||||--||-|||-|----------
XXXXXX|||||XXXXXXXXXXXXXX||||||||||||||||||||XXXXXXXXXXXXXXXXXXXXXXXXXXXXXXXXXXXXXXXXXXXXXXXXX|XXXXXXXXXXXXXXX|||||||||||||-XXXXXXXXXXXXXXXXXXXXXXXXXX
