------------------------------------------------------------------------------------------------------------------------------------------------------
------------------------------------------------------------------------------------------------------------------------------------------------------
------------------------------------------------------------------------------------------------------------------------------------------------------
------------------------------------------------------------------------------------------------------------------------------------------------------
------------------------------------------------------------------------------------------------------------------------------------------------------
------------------------------------------------------------------------------------------------------------------------------------------------------
-----------------------------------------------------------------------------------------------------------------------------------------------%------
------------------------------------------------------------------------------------------------------------------------------------------------------
------------------------------------------------------------------------------------------------------%%--------------------------------------------k-
-----------------------------------------------------g----------------------S------g----------%%%%---||--------CS--SCS-----%--------%----g%%---%------
-----------------------------------------k-k------gg----------gg-------g----------%%%%----------||--||---------------------||-------|-----|||%||%%%%%%
-----------------------------------------------|-----g----------------|||--%%-----||||%%%%%%%%%%%%%%%%-------g%-----ggg%%-||||gggggggggg%%-|||||||||||
-------------------------------------%%--------|-%%%%%%%%%%%%%%%%---%%%%%%%%|----|||||||||||||--|||||||%%%%%%%--------|||-|||||||||||||||-||||||||||||
--------------------------g-%%%%%%%%%|%%%%%%%%%||||||||||||||||||---|||||||||---%|||||||||||||--|||||||||||||||-------|||%%|||%||||||%%%%-||||||||||||
------%%%%%------------------||||||||||||||||||||||||||||||||||||---||||||||||--||||||||||||||--|||-||||||||||-------|||||||||||||||||||||||||||||||||
XXXXXX|||||XXXXXXXXXXXXXX---|||||XXXX||||||||||||||||||||||||||||--||||||||||---|||||||||||||||X||||||||||||||----XXXX||||||||||||||||||||||||||||||||
