------------------------------------------------------------------------------------------------------------------------------------------------------
------------------------------------------------------------------------------------------------------------------------------------------------------
------------------------------------------------------------------------------------------------------------------------------------------------------
------------------------------------------------------------------------------------------------------------------------------------------------------
------------------------------------------------------------------------------------------------------------------------------------------------------
------------------------------------------------------------------------------------------------------------------------------------------------------
------------------------------------------------------------------------------------------------------------------------------------------------------
------------------------------------------------------------------------------------------------------------------------------------------------------
------------------------------------------------------------------U-----------------------------------------------------------------------------------
----------------------------------------------------------------------------------------------------------------------------S-------------------------
------------------------------------------------------------------------------%-----------------------------------------------------------------%%%%%-
---------------------------------------ggkgkkkgk---------------%%%%%%%%--%%--------------gg--g--------------------------------------------------|||||-
--------------------------g---%%%%%%%-------------------------|||||||||||||%%%%%%%%%%%%---------------------------------------------------------||||||
------------------------------|||||||--------------------|---||||||||||||||||||||||||||---------------------------------------------------------||||||
------%%%%%-------------------|||||||-%%%%%%%%S----------|--%||||||||||||||||||||||||||---------------------------------------------------------||||||
XXXXXX|||||XXXXXXXXXXXXXX---XXXXXXXXXX||||||||||XXXXXXXXX|--X||||||||||||||||||||||||||--XXXXXXXXXXXXXXXXXXXXXXXXXXXXXXXXXXXXXXXXXXXXXXXXXXXXXXX||||||
