------------------------------------------------------------------------------------------------------------------------------------------------------
------------------------------------------------------------------------------------------------------------------------------------------------------
------------------------------------------------------------------------------------------------------------------------------------------------------
------------------------------------------------------------------------------------------------------------------------------------------------------
------------------------------------------------------------------------------------------------------------------------------------------------------
------------------------------------------------------------------------------------------------------------------------------------------------------
------------------------------------------------------------------------------------------------------------------------------------------------------
------------------------------------------------------------------------------------------------------------------------------------------------------
------------------------------------------------------------------------------------------------------------------------------------------------------
------------------------------------------------------------------------------------------------------------------------------------------------------
------------------------------------------------------------------------------------------------------------------------------------------------------
------------------------------------------------------------------------------------------------------------------------------------------------------
---------------------------------------------------------------------------------------------------------------------------------%%%%%%%%-%-----------
------------------------------------------------%%%%%%%%%---%%%%%%%%%%%%----------------------%%--%%%%%%%%%%%%%%%%%%-------------||-|||-|||%%%%%%%%-%%
------%%%%%-------------------------------------|||||||||---|-||||||||||-----%%%------------%%%%%|||||||||||||||||||%%%%%%%%%%%%-||%%||||||||||||||-||
XXXXXX|||||XXXXXXXXXXXXXX----XXXXXXXXXXXXXX---XXX||||||||---|-||||||--||-----|||------XXX---||||||||||||||-||||||||||||||||||||||||||||||||||||||||-||
