------------------------------------------------------------------------------------------------------------------------------------------------------
------------------------------------------------------------------------------------------------------------------------------------------------------
------------------------------------------------------------------------------------------------------------------------------------------------------
------------------------------------------------------------------------------------------------------------------------------------------------------
------------------------------------------------------------------------------------------------------------------------------------------------------
------------------------------------------------------------------------------------------------------------------------------------------------------
------------------------------------------------------------------------------------------------------------------------------------------------------
------------------------------------------------------------------------------------------------------------------------------------------------------
------------------------------------------------------------------------------------------------------------------------------------------------------
---------------------------------------------------------------------------------------------gg-gg--gggg---SCS----------------------------U-----------
--------------------------------------------------------------%%%%%%%%%%%%%%%%------------------------------------------------------------------%%%%%%
--------------------------------------kgkgkgkggg---------------|||-|||||||||||---%%%%%%%-g%-------------------------ggggg---g---g-----g---------||||||
-----------------------------%%%%%%%-%%------------------%%--%%%%%%%%%%%%%%%%%%%%%%|||||--------------------------------------------------------||||||
----------------------------|||||||||||------------------||---|||||||||||||||||||||||||||-|-----------------------------------------------------||||||
------%%%%%------------------|||||||-|%%%%%%%%|----------||---|||||||||||||||||||||||||||-|-----------------------------------------------------||||||
XXXXXX|||||XXXXXXXXXXXXXX||-||XXXXXXX||||||||||XXXXXXXXXXXX--X|||||||||||||||||||||||||||XXXXXXXXXXXXXXXXXXXXXXXXXXXXXXXXXXXXXXXXXXXXXXXXXXXX-XX|||||X
