------------------------------------------------------------------------------------------------------------------------------------------------------
------------------------------------------------------------------------------------------------------------------------------------------------------
------------------------------------------------------------------------------------------------------------------------------------------------------
------------------------------------------------------------------------------------------------------------------------------------------------------
------------------------------------------------------------------------------------------------------------------------------------------------------
------------------------------------------------------------------------------------------------------------------------------------------------------
------------------------------------------------------------------------------------------------------------------------------------------------------
------------------------------------------------------------------------------------------------------------------------------------------------------
------------------------------------------------------------------------------------------------------------------------------------------------------
------------------------------------------------------------g-----------------------------------------------------------------------------------------
----------------------------------------------------------------------------------------------------------------------------------------------%%%%%%%%
------------------------------------------------------------------------------------------gg%---%%--%----------------------|%-%%%gg%%gg%%%%%%%||||||||
-------------------------------------%--------------%%%%%%%%%%%%%%--%%%%%%%%%------%%%%%---|----||--|%-%%%%%%--------------||---|----------|||||||||||
------------------------------%%%%%%%||---%%%%%%%%--|||||||||||||---|||||||||----%%%|||%%%%%%%%%||--||--|||||--------%%%%%%%%%%%%%%%%%%%%%%|||||||||||
------%%%%%--------------------|||||||----|||||||%|||||||||||||||%-||||||||||---|||||||||||||||||||%%%%%%%%|%%--------||||||||||||||||||||||||||||||||
XXXXXX|||||XXXXXXXXXXXXXX----XXXXXXXXX----|||||||||||||||||||||||||||||||||||---||||||||||||||||||||||||||||||------XX||||||||||||||||||||||||||||||||
