------------------------------------------------------------------------------------------------------------------------------------------------------
------------------------------------------------------------------------------------------------------------------------------------------------------
------------------------------------------------------------------------------------------------------------------------------------------------------
------------------------------------------------------------------------------------------------------------------------------------------------------
------------------------------------------------------------------------------------------------------------------------------------------------------
------------------------------------------------------------------------------------------------------------------------------------------------------
------------------------------------------------------------------------------------------------------------------------------------------------------
------------------------------------------------------------------------------------------------------------------------------------------------------
------------------------------------------------------------------------------------------------------------------------------------------------------
------------------------------------------------------------------------------------------------------------------------------------------------------
------------------------------------------------------------------------------------------------------------------------------------------------------
-----------------------------------------------------------------------------------------------------------%%%%%%%%%%%--------------%-----------------
-------------------------------------------------%%%---------------------------------------%%--%%%%%%%%%%||||||||||||||%F%%%%%%%%%%%%%%|||%2%%%%%-----
-----------------------------------------------%%|||%%%---%%-------------------------%%%%%%||||||||||||||||||||||||||||||||||||||||||||||||||||||--%%%
------%%%%%-----------------------------------||||||||||--||--------------------------|||||||||||||||||||||||||||||||||||||||||||||||||||||||||%%%%|||
XXXXXX|||||XXXXXXXXXXXXXX-----XXXXXXXXXXXXXXXXXX||||||||--||-----XX----X|--XXXX-XXXXXX||||||||||||||||||||||||||||||||||||||||||||||||||||||||||||||||
