------------------------------------------------------------------------------------------------------------------------------------------------------
------------------------------------------------------------------------------------------------------------------------------------------------------
------------------------------------------------------------------------------------------------------------------------------------------------------
------------------------------------------------------------------------------------------------------------------------------------------------------
------------------------------------------------------------------------------------------------------------------------------------------------------
------------------------------------------------------------------------------------------------------------------------------------------------------
------------------------------------------------------------------------------------------------------------------------------------------------------
------------------------------------------------------------------------------------------------------------------------------------------------------
------------------------------------------------------------------------------------------------------------------------------------------------------
------------------------------------------------------------------------------------------------------------------------------------------------------
--------------------------------------------------------------------------------------------g-------------------%%--------g-------%--%-%%%%%----------
-----------------------------------gk------------%%----------gg-gkg----g-------------------------------%|g------|||---------------------|||||---------
---------------------------------------------%---||--------------------------------------------%--------|----|-|||||%----%|--%%--%%-%%-%||||----------
---------------------------------------|-----|--|||%%%%%----%--%%%%---------------------------||--%%%%%%%%%-%||||||||----||--||--||-||-|||||%%%-------
------%%%%%--------------------%%---------------||||||||----|----||------------|------------|%|||-|||||||||-|||||||%%%%%%%%%%%|%-||%%|-||||||||------%
XXXXXX|||||XXXXXXXXXXXXXX---XXXXXXXXXXXXXXXXXXXXXX|XXXX||--XXXXXXXXXXXXXXXXXXXXXXXXXXXXXXX--|||||-|||||||||-|||||||||||||||||||||||||||||||||||--X---|
