--------------------------------------------------------------------------------------------------------------------------------------------------------------------------------------------------------
--------------------------------------------------------------------------------------------------------------------------------------------------------------------------------------------------------
--------------------------------------------------------------------------------------------------------------------------------------------------------------------------------------------------------
--------------------------------------------------------------------------------------------------------------------------------------------------------------------------------------------------------
--------------------------------------------------------------------------------------------------------------------------------------------------------------------------------------------------------
--------------------------------------------------------------------------------------------------------------------------------------------------------------------------------------------------------
-----------------------------------------------------------------------------------------------------------------C--------------------------------------------------------------------------------------
-----------------------------------------------------------------------------------------------------------------------------------------------22-----r------g------------------------------------------
----------------------------------------------------------------------------g--------------------------%---------------------------|--------X------------g--U-%-----------------------------------------
--------------------------------------------kSS-------X%----------------U----------------gC-----kU-----|------%-----%%--C----%g|||%||-|-|-U|||----------------|-----------------------------------------
--------------------------------------g|kCU|k--------------------%----r%%------%%%%%g%F%---%%%%%-g-||g||%%%%%%---%%g-g-----%%%%||T|||||T---||----------T--------%%%%%%%%%%%%%%---------------------%%F%%
-------------------------------%%%%%-%--------gkgkggg%%kgkgg%gg%%%%%%%-%-%%%%%%||||||||g%g-||g||||||%|-%||||||-|||----------||||||||||-||||||----------------------|----------|-----------%%%%%%|%|%%%%%
--------------------------%---%|||%%||-|||||||%|||||%%|||||||--------|---%||||||||||||||||||||%|g|||||||||||||---|---------||-|||||||||||||||----------------------------------|||||------||||||||||||||
-------------------------|%|||||||||||||%--|%|||-||||||||||||------------|||||||||||||||||||||||||||||||-|-|||||||------------||||||||||||||||------%%||||||||---------------|||||||||||||||||||||||||||
------%%%%%--------------||||||||||---||||||||||--------||---------------||||||||||||||||--||||||||||--%----||||||-----------|||||||||||||||||-----|||||||||||--------------------||||||||||||||||||||||
XXXXXX|||||XXXXXXXXXXXXXX||||||||X|X|||-|-||||||XXXXXXX------XXX-XXXXXXXXX||X|||||||||||XXXXX|||XXXXXXX|X|X||||||-XXX-XXXXXXX|||||||||||||||||XXX|||||||||||||||||X|-XXX--XXXXXX||||||||||||XX|||||||||X
