--------------------------------------------------------------------------------------------------------------------------------------------------------------------------------------------------------
--------------------------------------------------------------------------------------------------------------------------------------------------------------------------------------------------------
--------------------------------------------------------------------------------------------------------------------------------------------------------------------------------------------------------
--------------------------------------------------------------------------------------------------------------------------------------------------------------------------------------------------------
--------------------------------------------------------------------------------------------------------------------------------------------------------------------------------------------------------
--------------------------------------------------------------------------------------------------------------------------------------------------------------------------------------------------------
--------------------------------------------------------------------------------------------------------------------------------------------------------------------------------------------------------
--------------------------------------------------------------------------------------------------------------------------------------------------------------------------------------------------------
--------------------------------------------------------------------------------------------------------------------------------------------------------------------------------------------------------
--------------------------------------------------------------------------------------------------------------------------------------------------------------------------------------------------------
--------------------------------------------------------------------------------------------------------------------------------------------------------------------------------------------------------
--------------------------------------------------------------------------------------------------------------------------------------------------------------------------------------------------------
--------------------------------------------------------------------------------------------------------------------------------------------------|||--k----%%----------%%%%----------------------------
-------------------------------------------------%%%%%%%%%%-%%%%%%%%%%%%%%------------%%%----%%%%%-%--------------------%%%%%%%%%%%%%%%%%%%%%%%|||||||||||||||||||||||||||||||%%%%%---%-----------------
------%%%%%-------------------------------------|||||||||||||||||||||||||||--%%%%%|||||||----|||||%%%%%%||%|%%%%%%%%%%||||||||||||||||||||||||||||||||||||||||||||||||||||||||||||||--|--|--|-----------
XXXXXX|||||XXXXXXXXXXXXXX----XXXXXXXXXXXXX----|||||||||||||||||||||||||||||||||||||||||||--||||||||||||||||||||||||||||||||||||||||||||||||||||||||||||||||||||||||||||||||||||||||||||--|||||XXXXXXXF||
