--------------------------------------------------------------------------------------------------------------------------------------------------------------------------------------------------------
--------------------------------------------------------------------------------------------------------------------------------------------------------------------------------------------------------
--------------------------------------------------------------------------------------------------------------------------------------------------------------------------------------------------------
--------------------------------------------------------------------------------------------------------------------------------------------------------------------------------------------------------
--------------------------------------------------------------------------------------------------------------------------------------------------------------------------------------------------------
--------------------------------------------------------------------------------------------------------------------------------------------------------------------------------------------------------
--------------------------------------------------------------------------------------------------------------------------------------------------------------------------------------------------------
------------------------------------------------------------------------------------------------------------------------------------------------g-------------------------------------------------------
----------------------------------------------------------------g-------------------F----------g--------------------------------------------------------------------------------------------------------
--------------------------------------------------------------------------------------------------------------------------------------------------------------------------------------------------------
-------------------------------------------------------------------------------------------------------------------g-g---------------------%%----------T--------%%%%%%%%%%%%%%---------------------%%F%%
-----------------------------------------------k-k--g----------------------------------g-g---gg--------%%-%%%---------------%-------%%%||||||----------------------|----------|-----------%%%%%%|%|%%%%%
-------------------------------------------%%%%%%---%%-%------------------------%%%%------------g--%T-%---||||---|------------|-|--||||||||||----------------------------------|||||------||||||||||||||
--------------------------------------||%--|%|||---%%%--%%-%%-------------|%|%%%%%%%%%%%%%--%%%%%%%%-------|||||||------------||%|||||||||||||------%%||||||||---------------|||||||||||||||||||||||||||
------%%%%%---------------------------||||||||||--------||----------------|||||||||||||||--|||||||||---%----||||||-----------|||||||||||||||||-----|||||||||||--------------------||||||||||||||||||||||
XXXXXX|||||XXXXXXXXXXXXXX---XXXXXX|X|||-|-||||||XXXXXXX------XXX-XXXXXXXXX||X|||||||||||XXXXX|||XXXXXXX|X|X||||||-XXX-XXXXXXX|||||||||||||||||XXX|||||||||||||||||X|-XXX--XXXXXX||||||||||||XX|||||||||X
