--------------------------------------------------------------------------------------------------------------------------------------------------------------------------------------------------------
--------------------------------------------------------------------------------------------------------------------------------------------------------------------------------------------------------
--------------------------------------------------------------------------------------------------------------------------------------------------------------------------------------------------------
--------------------------------------------------------------------------------------------------------------------------------------------------------------------------------------------------------
--------------------------------------------------------------------------------------------------------------------------------------------------------------------------------------------------------
--------------------------------------------------------------------------------------------------------------------------------------------------------------------------------------------------------
--------------------------------------------------------------------------------------------------------------------------------------------------------------------------------------------------------
--------------------------------------------------------------------------------------------------------------------------------------------------------------------------------------------------------
-------------------------------------------------------------------------------------------------------------------------------------------------------------------g------------------------------------
--------------------------------------------------------------------------------------------------------------------------------------------------------------------------------------------------------
--------------------------------------------------------------------------------------------g------------------------------------%%-%%%%%%%-------------------------------------------------------------
------------------------------------------------------------------------------------------------------%%%%%%%%-%%%---------------||-||||||||-----------%%%%%%%%%%%--------------------------------------
----------------------------------------------%%%%%-----------------------------------------%%%%%%%%%-||||||||||||%|%%%%F%%%%%%%%%%%%%%||||||||--------k||||||||||%%%%----------------------------------
----------------------------------------------|||%|%%%%%%-%%%----------------------------%%|||||||||||%%%%%%|||||||||||||||||||||||||||||||||||------%%|||||||||||||||----------------------------------
------%%%%%-----------------------------------|||||||||||-|||---------------------------|||||||||||||||||||||||||||||||||||||||||||||||||||||||%%%%|||||||||||||||||||-------%%-------------------------
XXXXXX|||||XXXXXXXXXXXXXX-----XXXXXXXXXXXXXXXXX||||||||||-|||---XXXXXXXXXX-XXXXXXXXXXXXX||||||||||||||||||||||||||||||||||||||||||||||||||||||||||||||||||||||||||||||-------XXXXX-XX|XXXXXXXXXXXXXXXFXX
