--------------------------------------------------------------------------------------------------------------------------------------------------------------------------------------------------------
--------------------------------------------------------------------------------------------------------------------------------------------------------------------------------------------------------
--------------------------------------------------------------------------------------------------------------------------------------------------------------------------------------------------------
--------------------------------------------------------------------------------------------------------------------------------------------------------------------------------------------------------
-------------------------------------------------------------------------------------------------------------------------S-------------------------------S--S-S-----------------------------------------
---------------------------------------------------------------------------------------C%----%S-----------------------------gg-----------------------U%-------------------------------------------------
----------------------------------------------------%2St----------%S----------U----------------%S--X---X--------------%---------------------------------------------------------------------------------
----------------------------------U--------------UXC----S-------------%---------------------X-----%-----------------------------------------------------------------------------------------------------
--------------------------------------------------------------------------------------------------|-----------------------------------------------------------------------------------------------------
----------------------------------------------------------------------------------------------|-----------------|---------------------------------------------------------------------------------------
--------------------------g--------F-------------------------------------------------------------------------------g-g---------------------%%----------T--------%%%%%%%%%%%%%%---------------------%%F%%
---------------------------------------------------------------------------------------g-----g---------%%-%%%---------------%-------%%%||||||----------------------|----------|-----------%%%%%%|%|%%%%%
-------------------------------------------%%%%%%---%%-%------------------------%%%%------------g--%T-%---||||---|-----------------||||||||||----------------------------------|||||------||||||||||||||
--------------------------------------||%--|%|||---%%%%-%%-%%-------------%%%%%%%%%%%%%%%%--%%%%%%%%-------|||||||------------|%%|||||||||||||------%-||||||||---------------|||||||||||||||||||||||||||
------%%%%%---------------------------||||||||||--------||----------------|||||||||||||||--||||||||----%----||||||-----------|||||||||||||||||-----|||||||||||--------------------||||||||||||||||||||||
XXXXXX|||||XXXXXXXXXXXXXX---XXXXXX|X|||-|-||||||XXXXXXX------XXX-XXXXXXXXX||X|||||||||||XXXXX|||XXXXXXX|X|X||||||-XXX-XXXXXXX|||||||||||||||||XXX|||||||||||||||||X|-XXX--XXXXXX||||||||||||XX|||||||||X
