--------------------------------------------------------------------------------------------------------------------------------------------------------------------------------------------------------
--------------------------------------------------------------------------------------------------------------------------------------------------------------------------------------------------------
--------------------------------------------------------------------------------------------------------------------------------------------------------------------------------------------------------
--------------------------------------------------------------------------------------------------------------------------------------------------------------------------------------------------------
--------------------------------------------------------------------------------------------------------------------------------------------------------------------------------------------------------
--------------------------------------------------------------------------------------------------------------------------------------------------------------------------------------------------------
--------------------------------------------------------------------------------------------------------------------------------------------------------------------------------------------------------
--------------------------------------------------------------------------------------------------------------------------------------------------------------------------------------------------------
--------------------------------------------------------------------------------------------------------------------------------------------------------------------------------------------------------
--------------------------------------------------------------------------------------------------------------------------------------------|-----------------------------------------------------------
-------------------------------------------|--------------------------------------------------------------%%%%-----g-g---------%%T%%%------|-----------T--------%%%%%%%%%%%%%%---------------------%%F%%
-----------------------------------------------kgkggg---g----------------------g-g-----g%g---gg-%%|%%--%%-%|||--------------%-|||||||%-||||||----------------------|----------|-----------%%%%%%|%|%%%%%
--------------------------------%----------|||%%%---%%-%--||--------------%-%---|%%%-|||-|---|%-g||%T|%|||||||---|----------|-|||||||||||||||----------------------------------|||||------||||||||||||||
--------------------------g--%%%%%%---||%--|%|||---|%||-||-||-------------|||||%%%%%%%%|%|--%%%%%|||||-|---|||||||------------||||||||||||||||------%%||||||||---------------|||||||||||||||||||||||||||
------%%%%%------------------%|||||---||||||||||--------||---------------||||||||||||||||--||||||||||--%----||||||-----------|||||||||||||||||-----|||||||||||--------------------||||||||||||||||||||||
XXXXXX|||||XXXXXXXXXXXXXX|-||X|X|X|X|||-|-||||||XXXXXXX------XXX-XXXXXXXXX||X|||||||||||XXXXX|||XXXXXXX|X|X||||||-XXX-XXXXXXX|||||||||||||||||XXX|||||||||||||||||X|-XXX--XXXXXX||||||||||||XX|||||||||X
