--------------------------------------------------------------------------------------------------------------------------------------------------------------------------------------------------------
--------------------------------------------------------------------------------------------------------------------------------------------------------------------------------------------------------
--------------------------------------------------------------------------------------------------------------------------------------------------------------------------------------------------------
--------------------------------------------------------------------------------------------------------------------------------------------------------------------------------------------------------
--------------------------------------------------------------------------------------------------------------------------------------------------------------------------------------------------------
--------------------------------------------------------------------------------------------------------------------------------------------------------------------------------------------------------
--------------------------------------------------------------------------------------------------------------------------------------------------------------------------------------------------------
--------------------------------------------------------------------------------------------------------------------------------------------------------------------------------------------------------
--------------------------------------------------------------------------------------------------------------------------------------------------------------------------------------------------------
--------------------------------------------------------------------------------------------------------------------------------------------------------------------------------------------------------
------------------------------------------------------------------------------------------------------------%------g-g----------%-%%-------%-----------T--------%%%%%%%%%%%%%%---------------------%%F%%
-----------------------------------------------kgkggg--------------------------g-g-----g%g---gg--%--%--%%-%%||--------------%-||||-||%%||||||----------------------|----------|-----------%%%%%%|%|%%%%%
------------------------------%%%%%--------|%%%%%---%%-%------------------%-%---%%%%--||-----|%-g-|%T|%|||||||---|----------|-|||||||||||||||----------------------------------|||||------||||||||||||||
-------------------------------||||---||%--|%|||----%---|%-|--------------||||%%%%%%%%%%%%--%%%%%%||||-----|||||||------------||||||||||||||||------%-||||||||---------------|||||||||||||||||||||||||||
------%%%%%-----------------%%%||||---||||||||||--------||----------------|||||||||||||||--||||||||||--%----||||||-----------|||||||||||||||||-----|||||||||||--------------------||||||||||||||||||||||
XXXXXX|||||XXXXXXXXXXXXXX---|X|X|X|X|||-|-||||||XXXXXXX------XXX-XXXXXXXXX||X|||||||||||XXXXX|||XXXXXXX|X|X||||||-XXX-XXXXXXX|||||||||||||||||XXX|||||||||||||||||X|-XXX--XXXXXX||||||||||||XX|||||||||X
