--------------------------------------------------------------------------------------------------------------------------------------------------------------------------------------------------------
--------------------------------------------------------------------------------------------------------------------------------------------------------------------------------------------------------
--------------------------------------------------------------------------------------------------------------------------------------------------------------------------------------------------------
--------------------------------------------------------------------------------------------------------------------------------------------------------------------------------------------------------
--------------------------------------------------------------------------------------------------------------------------------------------------------------------------------------------------------
--------------------------------------------------------------------------------------------------------------------------------------------------------------------------------------------------------
--------------------------------------------------------------------------------------F----------C-----------------S-----------------------|-F----------------------------------------------------------
---------------------------------------------------------------------------------------------------------------------------------------------F---g-F----------------------------------------------------
------------------------------------%------------------------------CF-----------------X--------------T|--------------------------|-----%--gg-------S--2---|------------|----------%--------T------------
-----------------------------------------F----k---------g---------%------|------|---------|-----S-----k---%-------%%g--|%g--|-TFS---g----F2----|-F-C%-T--r------------2-FS--F-U--------------|---X------
------------------------------------||------S-------|--|------|----|------------F|-%-C--------%|------|-|||-|T|%-----%%---|%-|------Tg%-%-------%k--%-tS-kg|g%g-r-%k-S-%-%XF%|----%--%-t%--%%--%--g-----
---------------------------------%gS%----U-T------g|F|%-F---|-g---------||----tF|------gU------||||--%g%|--|T|-%-S%---||2-S--UF|---g---|-F----||---|%%--||SgC-|||---||---|S|%|-----|-|-T|--%-||TC|--|F-|
---------------------------------%--|---S--S--F--2%|------U|--|||-------%-|-|--|---||--k---2|2-S-X|-||--||%-|--g||--|||---%----|-F||--||||-2------|--X---|-|F|----|g-|-----||-t|||-|----------|-||T---||
------------------------------||---T--g-|SF------||--|-g-g||-SS-|-|-%-S|||g|S-|-||S|||-||X|--|--|--U|%-|--|--|-|||-S||-|-||-TS|||||-||2gg|F||g|-F||||---|||--|-|S---||-S---%|-|-||||--|----|||---|F-|-|-
------%%%%%--------------S----|C---X|g|r|||||--|2--|-S-%-S%|||||-TS-||S---||2F%|C-||||r-|||||%||g|||---g----||||||-C%-|g|-S||%---|-|||||r|%||-|TSS||-||||S--C----||-|2|--|--|||%FSC||---||-%|---||--|-ST
XXXXXX|||||XXXXXXXXXXXXXX--|X-X||XX2|X|XX|XXXXX|XX||||-|-|X||X||||-t|||XX-||-k-XXXF|X||-g||T|||X|k-||XX|X||X|-|X|||||SXg--XXg|||XX||X|-||X||||||||U--XS||||U|S||XX-2||X|X-XXXX|XX||-|XrSX||||S||XXXX||XX
