--------------------------------------------------------------------------------------------------------------------------------------------------------------------------------------------------------
--------------------------------------------------------------------------------------------------------------------------------------------------------------------------------------------------------
--------------------------------------------------------------------------------------------------------------------------------------------------------------------------------------------------------
--------------------------------------------------------------------------------------------------------------------------------------------------------------------------------------------------------
------------------------------------------------------------------------------------------------------------------------------------------------------------S-------------------------------------------
--------------------------------------------------------------------------------------------------------------------------------------------------------------------------------------------------------
--------------------------------------------------------------------------------------------------------------------------------------------------------------------------------------------------------
--------------------------------------------------------------------------------------------------------------------------------------------------------------------------------------------------------
------------------------------------------------------------g-------------------------------------------------------------------------------------------------------------------------------------------
--------------------------------------------------------------------------%g----------------------------------------------------------------------------------------------------------------------------
-------------------------------------------------------------------------------------------------------------------g-g---------------------%%----------T--------%%%%%%%%%%%%%%---------------------%%F%%
---------------------------------------------------------------------------------------g-----g---------%%-%%%---------------%-------%%%||||||----------------------|----------|-----------%%%%%%|%|%%%%%
-------------------------------------------%%%%%%---%%-%------------------------%%%%------------g--%T-%---||||---|-----------------||||||||||----------------------------------|||||------||||||||||||||
--------------------------------------||%--|%|||---%%%%-%%-%%-------------%%%%%%%%%%%%%%%%--%%%%%%%%-------|||||||------------|%%|||||||||||||------%-||||||||---------------|||||||||||||||||||||||||||
------%%%%%---------------------------||||||||||--------||----------------|||||||||||||||--|||||||||---%----||||||-----------|||||||||||||||||-----|||||||||||--------------------||||||||||||||||||||||
XXXXXX|||||XXXXXXXXXXXXXX---XXXXXX|X|||-|-||||||XXXXXXX------XXX-XXXXXXXXX||X|||||||||||XXXXX|||XXXXXXX|X|X||||||-XXX-XXXXXXX|||||||||||||||||XXX|||||||||||||||||X|-XXX--XXXXXX||||||||||||XX|||||||||X
