--------------------------------------------------------------------------------------------------------------------------------------------------------------------------------------------------------
--------------------------------------------------------------------------------------------------------------------------------------------------------------------------------------------------------
--------------------------------------------------------------------------------------------------------------------------------------------------------------------------------------------------------
--------------------------------------------------------------------------------------------------------------------------------------------------------------------------------------------------------
--------------------------------------------------------------------------------------------------------------------------------------------------------------------------------------------------------
--------------------------------------------------------------------------------------------------------------------------------------------------------------------------------------------------------
-----------------------------------------------------------------------------------------------------------------CX---------------------%--------S--%--C------------2S-2-C----C-SSSSC-------------------
-----------------------------------------------------------------------------------------------------%-%%%%X%t|------%%---|F---T---%----|-r-------%---r||||F-gg--t%------------t|-----------------------
------------------------------------C-SSC------------------------------C----g-%%-U------2---F|--|---||-%g|rX-|rT|||-||----|-g--|U%F|r%|C%---X%%%g%||||-|-|%%U%%|--|||||-|-------%|-||%%%%---------------
--------------------------------------ggggg-kSS%%%%%U-X%2%%---2%-%%-|-|-UgX-SC|g-%U%%%g|ggC-%---kU|%|%|||----|-|-|%|%%||C%|-|%g|||%||%|||-U|||||||||g||||||-||||-g-|||||----g--|----|---|---------------
-------------------------------------gg|kCU|k---|||T||||||gX-|||||||%-r%-|----|%%|%|||F|%g%%%%%%kg|||g||%%%%%%%|%%|g-g----|%|%|||T|||||T---|||---------T--------%%%%%%%%%%%%%%---------------------%%F%%
-------------------------%%%%%%%%%%%%%--------gk|kggg%|kgkgg|g|%||||%%%%|%%%%%%||||||||%||%|||||||||||-|||||||-|||----------||||||||||-||||||----------------------|----------|-----------%%%%%%|%|%%%%%
-------------------------|||||||||||||-||||||||||||||||||||||-||||||||||||||||||||||||||||||||||g|||||||||||||---|---------||-|||||||||||||||----------------------------------|||||------||||||||||||||
-------------------------|||||||||||||||%--|%|||-||||||||||||-------||-|||||||||||||||||||||||||||||||||-|-|||||||------------||||||||||||||||------%-||||||||---------------|||||||||||||||||||||||||||
------%%%%%--------------||||||||||---||||||||||--------||---------------||||||||||||||||--|||||||||||-|----||||||-----------|||||||||||||||||-----|||||||||||--------------------||||||||||||||||||||||
XXXXXX|||||XXXXXXXXXXXXXX||||||||X|X|||-|-||||||XXXXXXX------XXX-XXXXXXXXX||X|||||||||||XXXXX|||XXXXXXX|X|X||||||-XXX-XXXXXXX|||||||||||||||||XXX|||||||||||||||||X|-XXX--XXXXXX||||||||||||XX|||||||||X
