--------------------------------------------------------------------------------------------------------------------------------------------------------------------------------------------------------
--------------------------------------------------------------------------------------------------------------------------------------------------------------------------------------------------------
--------------------------------------------------------------------------------------------------------------------------------------------------------------------------------------------------------
--------------------------------------------------------------------------------------------------------------------------------------------------------------------------------------------------------
--------------------------------------------------------------------------------------------------------------------------------------------------------------------------------------------------------
--------------------------------------------------------------------------------------------------------------------------------------------------------------------------------------------------------
--------------------------------------------------------------------------------------------------------------------------------------------------------------------------------------------------------
--------------------------------------------------------------------------------------------------------------------------------------------------------------------------------------------------------
---------------------------------------------------------------------------------------------------------------%----------------------------------------------------------------------------------------
--------------------------------------------------------------------------------------------------------------------------------------------------------------------------------------------------------
--------------------------------------------------------------------------------------------------------------------------------------------------------------------------------------------------------
-------------------------------------------------------------------------------------------------------------------%---------------------------------------%%%%-----------------------------------------
------------------------------------------------------------------------------------------------%%%%%%%%--------|-%|%%%%F%%%%%%%%%%%%%%%%-%2%%%%%------k%-|||||---%%%%%%--------------------------------
------------------------------------------------%%%%%%%---%---------------------------%%%%%%%%%%|||||||%%%%%%%%%%%|||||||||||||||||||||||||||||||%%%%%%%%%%|||%%%%|||||-%%------------------------------
------%%%%%--------------------------------------||||||---||------%%%%%%%%%--%---------|-||||||||||||||||||||||||||||||||||||||||||||||||||%%%%%%%|||||||||||||||||||||-|||-----g%%%%%%-----------------
XXXXXX|||||XXXXXXXXXXXXXX-----XXXXXXXXXXXXXXXXXXX||||||---||------||---||--||||-----XXXX-||||||||||||||||||||||||||||||||||||||||||||||||||||||||||||||||||||||||||||||-|||----||||||-T--X|XXXXXXXXXXFXX
