--------------------------------------------------------------------------------------------------------------------------------------------------------------------------------------------------------
--------------------------------------------------------------------------------------------------------------------------------------------------------------------------------------------------------
--------------------------------------------------------------------------------------------------------------------------------------------------------------------------------------------------------
--------------------------------------------------------------------------------------------------------------------------------------------------------------------------------------------------------
--------------------------------------------------------------------------------------------------------------------------------------------------------------------------------------------------------
--------------------------------------------------------------------------------------------------------------------------------------------------------------------------------------------------------
--------------------------------------------------------------------------------------------------------------------------------------------------------------------------------------------------------
--------------------------------------------------------------------------------------------------------------------------------------------------------------------------------------------------------
--------------------------------------------------------------------------------------------------------------------------------------------------------------------------------------------------------
--------------------------------------------------------------------------------------------------------------------------------------------------------------------------------------------------------
-------------------------------------------------------------------------------------------------------------------g-g---------------------%-----------T--------%%%%%%%%%%%%%%---------------------%%F%%
-----------------------------------------------k-k-gg----------------------------------g-g---gg--------%%-%%%|--------------%--------%%||||||----------------------|----------|-----------%%%%%%|%|%%%%%
-------------------------------------------%%%%%%---%%-%------------------------%%%%----------%-g--%T-%---||||---|----------|-|||||||||||||||----------------------------------|||||------||||||||||||||
--------------------------g-----------||%--|%|||---%%%--%%-%--------------|||%%%%%%%%%%%%%--%%%%%%%%-------|||||||------------||%|||||||||||||------%%||||||||---------------|||||||||||||||||||||||||||
------%%%%%---------------------------||||||||||--------||----------------|||||||||||||||--|||||||||---%----||||||-----------|||||||||||||||||-----|||||||||||--------------------||||||||||||||||||||||
XXXXXX|||||XXXXXXXXXXXXXX---XXXXXX|X|||-|-||||||XXXXXXX------XXX-XXXXXXXXX||X|||||||||||XXXXX|||XXXXXXX|X|X||||||-XXX-XXXXXXX|||||||||||||||||XXX|||||||||||||||||X|-XXX--XXXXXX||||||||||||XX|||||||||X
