--------------------------------------------------------------------------------------------------------------------------------------------------------------------------------------------------------
--------------------------------------------------------------------------------------------------------------------------------------------------------------------------------------------------------
--------------------------------------------------------------------------------------------------------------------------------------------------------------------------------------------------------
--------------------------------------------------------------------------------------------------------------------------------------------------------------------------------------------------------
--------------------------------------------------------------------------------------------------------------------------------------------------------------------------------------------------------
--------------------------------------------------------------------------------------------------------------------------------------------------------------------------------------------------------
--------------------------------------------------------------------------------------------------------------------------------------------------------------------------------------------------------
--------------------------------------------------------------------------------------------------------------------------------------------------------------------------------------------------------
--------------------------------------------------------------------------------------------------------------------------------------------------------------------------------------------------------
--------------------------------------------------------------------------------------------------------------------------------------------------------------------------------------------------------
---------------------------------------------------------k----------------------------------------------------------------------------------------------------------------------------------------------
---------------------------------------------------------------------------------------------------------------------------------------------------------------------------%%%%%%%%---------------------
--------------------------------%--------------------------------%%%%-------%%%%%%-----------------------------------------------------------------------------------------||||||||||||%%%%%%%%%%%%%%F%%
--------------------------------||-----------------------------%||||||%--%%%|||||||%-----------------------------%%-------------------------------%%-------------------%%%%||||||||||||||||||||||||||%||
------%%%%%---------------------||-----------------------------||||||||--|||||||||||-----------------------------||-------------------------------|||------------------|||||||||||||||||||||||||||||||||
XXXXXX|||||XXXXXXXXXXXXXX---XXXXXXXXXXX--------XXXXXXXXXX---XX-||||||||||||||||||||||---XXXXXXXXX--XXXX-XXXXXXXXX||------XXXX------------X--------|||-------------XXXX||||||||||||||||||||||||||||||||||
