--------------------------------------------------------------------------------------------------------------------------------------------------------------------------------------------------------
--------------------------------------------------------------------------------------------------------------------------------------------------------------------------------------------------------
--------------------------------------------------------------------------------------------------------------------------------------------------------------------------------------------------------
--------------------------------------------------------------------------------------------------------------------------------------------------------------------------------------------------------
--------------------------------------------------------------------------------------------------------------------------------------------------------------------------------------------------------
--------------------------------------------------------------------------------------------------------------------------------------------------------------------------------------------------------
--------------------------------------------------------------------------------------------------------------------------------------------------------------------------------------------------------
--------------------------------------------------------------------------------------------------------------------------------------------------------------------------------------------------------
--------------------------------------------------------------------------------------------------------------------------------------------------------------------------------------------------------
--------------------------------------------------------------------------------------------------------------------------------------------------------------------------------------------------------
------------------------------------------------------------------------------------------------------------%------g-g---------------------%-----------T--------%%%%%%%%%%%%%%---------------------%%F%%
-----------------------------------------------k-kggg----------------------------g-----g%g---gg-----%--%%-%%||--------------%-||||-||%%||||||----------------------|----------|-----------%%%%%%|%|%%%%%
-------------------------------------------|%%%%%---%%-%------------------%-%---%%%%--||-----|%-g-|%T|%||-||||---|----------|-|||||||||||||||----------------------------------|||||------||||||||||||||
------------------------------%%%%%---||%--|%|||---%%%--%%----------------||||%%%%%%%%%%%%--%%%%%%%|||-----|||||||------------||||||||||||||||------%-||||||||---------------|||||||||||||||||||||||||||
------%%%%%-------------------|||||---||||||||||--------||----------------|||||||||||||||--||||||||||--%----||||||-----------|||||||||||||||||-----|||||||||||--------------------||||||||||||||||||||||
XXXXXX|||||XXXXXXXXXXXXXXX--XXXXXX|X|||-|-||||||XXXXXXX------XXX-XXXXXXXXX||X|||||||||||XXXXX|||XXXXXXX|X|X||||||-XXX-XXXXXXX|||||||||||||||||XXX|||||||||||||||||X|-XXX--XXXXXX||||||||||||XX|||||||||X
