--------------------------------------------------------------------------------------------------------------------------------------------------------------------------------------------------------
--------------------------------------------------------------------------------------------------------------------------------------------------------------------------------------------------------
--------------------------------------------------------------------------------------------------------------------------------------------------------------------------------------------------------
----------------------------------------------------------------------------------------------------------------------t------------t--------t--------------t--------------------------------------------
--------------------------------------------------------------------------------------------------------------------------------------------------------------------------------------------------------
----------------------------------------S-S--------------%-----------%%--%------------------------S-----t---%-------------------------%-----------------------------------------------------------------
-------------------------------------------------------------------------|--------%%%%%-|T%%-%%--C|-%U---S-t|-%-|CXSS--%%%%-F%SS%%SCSSSr%-%%%%%%%S%%%t%Cgg%%%-%%%%%%2S222CCCS2CSSSSSCS------------------
-----------------------------------------------------------------S-%---------%%%--F|g-||%||r--|-%|--%%-%%%%X%t|-||-%|%%Sg-|F%%XT--|%%%gg|%rgggr22|%||Ur||||Fggg|%t%|%|t-|--%%%%t|%%%%%%%%%%%%%----------
--------------------------------S--SCSSSCCSSSSSXSSCSSF|C-S%---%%--%%%%XCg-2|gX%%%U|--|--2||%F|%T||-U||U|||rX%|rT||||||-|||||gSg|U|F|r%|-%|||X%%%||||||||||||U||||||||||||%|%||||%||||%%%%%||-|----------
------------------------------tC--ggg2ggggggkSS%%%%%U|X%2%%C-g2%-%|T|||gUgX-SC|g%%U%|%g|ggC|%|-|kU|%||||||||||%|-|%|%%||C%|||%g|||%||%|||-U|||||||||g||||||||||||g||||||||||g|||t||||||||||-|-----------
----------k-r------------------------gg|kCU|kgg-|||T||||||gXg|||||||%-r%%|%%-|||||%|||F|%g%|%%%%k||||g||||%%%%||%%|g-g|||-|||%|||T|||||T---|||---------T--|-|---%%%%%%%%%%%%%%---------------------%%F%%
-------------------------%%%%%%%%%%%%%--------gk|kggg||kgk|||g|%||||%%%||||%||||||||||||||%|||||||||||||||||||-|||----------||||||||||-||||||----------------------|----------|-----------%%%%%%|%|%%%%%
-------------------------|||||||||||||X|||||||||||||||||||||||||||||||||||||||||||||||||||||||||||||||||||||||---|---------||||||||||||||||||----------------------------------|||||------||||||||||||||
-------------------------|||||||||||||||%--|%||||||||||||||||----|--||||||||||||||||||||||||||||||||||||-|-|||||||------------||||||||||||||||------%%||||||||---------------|||||||||||||||||||||||||||
------%%%%%--------------||||||||||---||||||||||--------||---------------||||||||||||||||--|||||||||||-|----||||||-----------|||||||||||||||||-----|||||||||||--------------------||||||||||||||||||||||
XXXXXX|||||XXXXXXXXXXXXXX||||||||X|X|||-|-||||||XXXXXXX------XXX-XXXXXXXXX||X|||||||||||XXXXX|||XXXXXXX|X|X||||||-XXX-XXXXXXX|||||||||||||||||XXX|||||||||||||||||X|-XXX--XXXXXX||||||||||||XX|||||||||X
