--------------------------------------------------------------------------------------------------------------------------------------------------------------------------------------------------------
--------------------------------------------------------------------------------------------------------------------------------------------------------------------------------------------------------
--------------------------------------------------------------------------------------------------------------------------------------------------------------------------------------------------------
--------------------------------------------------------------------------------------------------------------------------------------------------------------------------------------------------------
--------------------------------------------------------------------------------------------------------------------------------------------------------------------------------------------------------
--------------------------------------------------------------------------------------------------------------------------------------------------------------------------------------------------------
--------------------------------------------------------------------------------------------------------------------------------------------------------------------------------------------------------
--------------------------------------------------------------------------------------------------------------------------------------------------------------------------------------------------------
--------------------------------------------------------------------------------------------------------------------------------------------------------------------------------------------------------
------------------------------------------------------------------------------------------g-------------------------------------------------------------------------------------------------------------
-----------------------------------------------------------------------------------------------------------------%%%%%%%%-------%-----------------------------------------------------------------------
--------------------------------------------------------------------------------------------------------g%%%%%%|||||||||||---------------------------------|--------------------------------------------
------------------------------------------%--------%--------------------------------------%%-%%---%--%||--||-|||||||||||||-----%%--%%-%|-----------------------------------------%%%%%-%%------------F%%
--------------------------------------------------|||-----------------------%%%%%%%-------|---|---||-|||||||-|||||||||||||-|---||--||-||-----------------%%%%%%-----------------|||||||||-|-------------
------%%%%%--------------%%-X--%%-k%-------------|-||--------------|--------||||||--------||%%%%--||-|||||||||||||||||||||-|--%||-|||-||%%%%%%-%---------||||||-----|----------||%|||%%%%%%%%%%%%%%%%F%%
XXXXXX|||||XXXXXXXXXXXXXX|||||||||||XXXXXXXXXXXXXXXXXX---XXXXXXXXXXXX--XXXXXX|XXXXXXXXXXXXX|||||-|||||||||||||||||||||||||-||-|||-|||-||||||||X|----XXXXX||||||----|X--XXXXXXX|||||||||||||||||||||||X||
