#-||--|||--tkk------%%%%%---%%%%%----------------------------------------------------------------------||||||||||||---||||||||||---||||||||||--|||||%%
--%%||--||||---|||||||||||---||||||||||XXXX--XXXX|||--||||||||---|||XXXXX--XXXXX|||---|||||||---||||||---||||||--|||||||||||||||||||--|||||--|||||||||
|||||||||||||||||||X|||||||||||||||||||||||||||||||||||||||||||||||||||||||---------------------------------------------------------------------------
--------------------------------------------------------------------%%%%%%%--------tk---------C-------------------------------------------------------
------------------------------------------------------------------------------------------------------------------------------------------------------
------------------------------------------------------------------------------------------------------------------------------------------------------
------------------------------------------------------------------------------------------------------------------------------------------------------
------------------------------------------------------------------------------------------------------------------------------------------------------
----------------y-------------------------------------------------------------------------------------------------------------------------------------
-----------------------------------------------------------------------------------------------%%%--%%%----||-----%%%%%%----|||-----------kty|r|------
------------------------------------------------------------------------------------------------------------------------------------------------------
------------------------------------------------------------------------------------------------------------------------------------------------------
------------------------------------------------------------------------------------------------------------------------------------------------------
------------------------------------------------------------------------------------------------------------------------------------------------------
------------------------------------------------------------------------------------------------------------------------------------------------------
------------------------------------------------------------------------------------------------------------------------------------------------------
