#------------------rt------------------------------------------#---#----------------------------------------------------------------------------------
------------------------------------------------------------------------------------------------------------------------------------------------------
------------------------------------------------------------------------------------------------------------------------------------------------------
------------------------------------------------------------------------------------------------------------------------------------------------------
-------------------------------------------------------%%%%%--%%%%%|||||||--#--#---|||||--||-----k-|||||---||||||||---|||||||--|||||||||--------------
---|||||%%%%%%%%%%%%%||||---||||||||--|||||||||||||||||||%%%%---%%%%----------------------------------------------------------------------------------
--------------%%%%%%%%%%%%%-|-|r------------%%%%%---%%%%%----------------------%%%---%%%---------------rt||y|---||||----------------------------------
------------------------||||||||||||||||||||||XXXXXXXX||||||||||||---|||XXXX|||||||||||||||XXX--XXX|||---|||||||---||||||||||--||||||--|||||||---|||||
|||||||||||||||||||---||||||---|||||||||||||||||||||---||||||||||||||XX---XXXXXXXXXXXXX||||---|||||XXXXXXXXXXXX|||--|||||||---|||||XXXXXXXXXXX--XXXXXX
||||||||||XXXXX---XXXXX||||---||||||||---|||||||||--|||||XXXXX---XXXXX|||--|||||||||||||---|||||---||||--||||||---||||XX---XX||--|||||||||||||||||||||
||||||||||||||||||||||||||||||||||--------------------------------------------------------------------------------------------------------------------
----------------------------------------------------------------------------------------------------------------------------------|||||||||-----------
------------------------------------------------------------------------------------------------------------------------------------------------------
------------------------------------------------------------------------------------------------------------------------------------------------------
------------------------------------------------------------------------------------------------------------------------------------------------------
------------------------------------------------------------------------------------------------------------------------------------------------------
