---------------#---#----%%%%%%%%%%%%%%%%|||||||||||%%%%%%%%%%%%%|||||--y||||%%%%%%%%%%|||||||||||||||||||||||%%%%%--%%%%%||||------------t|--tt-------
---|||--|||--------%%%%%%%%%------------%%--%%%%%%---------------------------------------------------------------------------------X-|----------------
S-US-CUC--------#---#-----------------------------------------------------------------------------------------------------|||----|||||||%%%%----------
-----------------------|||||--%%---%%---------------------%%%%%%%%%%%%%%-------Tt--tt--|||||---||||-----------#####------------------%%---%%----TC-||-
-tt%%---%%%%%--%%%|||---|||%%%%%%%%----||g|||---###--###---------------------------%%%%---%%%%----%%%%%--%%%||||||||||||||||||||||||||||||||||||||||||
||||||||%%%%%%|||||---|||||--------------|||--|||%%%--%%%|||||||||||||%%-----------------------||||||-g-||||--###--###-----##--##----#--#-------------
-----------|||||--g-%%%%%---%%%%%||||||||%||||||||||||||||||||||||||||||||||||||||||||||||---|||XXXXXXXXXXXXX||---|||||--|||||---||||||--|||||||||||||
|||||||||||||---||||||||--|||||XXX---XXX|||||--|||||||||--||||XXXX--XXXX|||--||||||---|||XXXXXXXXXX|||--|||||||---|||||||---||||||||||||||||||||||||||
||||||||||||||||||||||||||||||||||||||||--------------------------------------------------------------------------------------------------------------
------------------------------------------------------------------------------------------------------------------------------------------------------
------------------------------------------------------------------------------------------------------------------------------------------------------
------------------------------------------------------------------------------------------------------------------------------------------------------
-------------------------------------------------------------------------------------|||||--2----------------------------------------|||||||y---------
------------------------------|||---||||||||---|||||---------||||||||||%%%%%%%%%%%||||---|||||||---|||-----tt-----|||||||||||||||||||||---%%%%%---%%%%
%-------------------------------------------------------------------|||||||||||||||||||--||||%%%%---%%%%%%%---%%%||||||||||||||||||||||||||||||---||||
|||||||||%|||||||||||||||||||||||||||||||||||||||||||||||||||||||||||XXXXXXXXXXXXXX|||---||||XX---XX||||||||||XXX---XXX|||||--|||||||||||||XXXXXX|||||
