-------------------------------%%%%%---%%%%%|||---|||||||---||||--###--###--%|||||||||||||%%%%---------------%%%%---%%%%|||||---|||||%%%---%%%|||||---
-----###---###----------------------------------------------------------------------------------------------------------------------------------------
------------------------------------------------------------------------------------------------------------------------------------------%%%%%%%-----
------------------------------------------------------------------------------------------------------------------------------------------------------
------------------------------------------------------------------------------------%%%%%-----------------------------------------------------------##
--##--------------------------||||----------------------------#--#------------------------------------------------------------------------------------
---------------------------%%%%%%-------------------------------------%%%%----------------------------------------------------------------------------
------------------------------------------------------------------------------------------------------------------------------------------------------
--------------------------------------------------------------------------------------------------------------------------------------tt--------------
----------------------------------------------------|||||-----------------#---#-----------------------------------------------------------------------
------------------------------------------------------------------------------------------------------------------------------------------------------
------------------------------------------------------------------------------------------------------------------------------------------------------
------------------------------------------------------------------------------------------------------------------------------------------------------
------------------------------------------------------------------------------------------------------------------------------------------------------
--------------------------------------------------------------------------------------------------------------y||||||---------------------------------
------------------------------------------------------------------------------------------------------------------------------------------------------
