G%-%-%---------%-%%%%%-%%%%-%%%|||||-%-||||||||||||||||-----#%%%%%%%%%|||||||||||||||||%||||---|||||||||||||||--g|||||||||||||||||---||||||||||---||||
|||||||||XX---|||||||||||||||||||||---|||---||||XXXXXXXXXXX--||XXXFXXXXXXX||X--XXXXXXXXXXXXXXXXXXXFXXXXXXXXXXXXXXXXXXXXXXXXXXXXXXXXXXXXXXXXXXXXXXXXXXX
XXXXXXXXXXXXXXXXXXXXXXXXXXXXXFXXXXXXXXXXXXXXXXXXXXXXXXXXXXXXXXXXXXXXXXXXXXXXXXXXXXXXXXXXXXXXXXXX--------|XXX----------|||---|||||------||||-----------
----------------------------------------------------------#%%%%%%%%%%%%%%%-%%|||||||||||||||-%-||||||||||||||||--%%%-%%%%%%%%%%%%-|||||||||--|||||||||
||||||||||||||||---|||||||||||||||||||||||||||||||----------||||||||||||||||||||||XXXXXXXXXXXXXXXXXXXXXXXXX-XXXXFXXXXXXXXXXXXXXXXXXXXXXFXXXXXXXXXXXXXX
XXXXXXXXXXXXXXXXXXXXXXXXXXXXXXXXXXXXXXXXXXXXXXXXXXXXXXXXXXXX|X|F--XXXXXXXXXXXXXXXXXXXXXXXXXXXXXXXXXXXXXXXXXXXXXXXXXXXXXXXXXXXXXXX-XXXXFXXXXXXXXXXXXXXX
XXXXXXXXXXXXXXXXXXXXXXXXXXFXXXXXXXXXXXXXXXXXXXXXXXXXXXXXXXXXXXXXXXXXXXXXXXXXXXXXXXXXXXXXXXXXXX--------------------------------------------------------
------------------------------|S-XXXXXXXXX-----%------------------------------------------------------------------------------------------------------
------------------------------------------------------------------------------------------------------------------------------------------------------
--------------------------------------------------------------------------------------------------------------------------------S---------------------
-----------------------------------------------------------------------------|-SS2--------------------------------------------------------------------
----------------------------------------------------------------------------------------------------------------------------%-------------------------
---------%--------------------------------------------------------------------------------------------------------------------------------------------
------------------------------------------------------------------------------------------------------------------------------------------------------
------------------------------------------------------------------------------------------------------g-------S---------------------------------------
------------------------------------------------------------------------------------------------------------------------------------------------------
