%-------------||||||-----------------||---||%%%%%%%%%%%%%%%---%%%%||%%%%%%%%F%%%%%%%%%%%%%%%%%%%%%%%%%%%%%%%%%%%%%%%%%%%%%%%%%%%%%%%%%%%%%%%||||||||||2025-07-09 13:42:51.165798: I external/org_tensorflow/tensorflow/cc/saved_model/reader.cc:45] Reading SavedModel from: models/LSTMs/mario_lstm_savedmodel
2025-07-09 13:42:51.199693: I external/org_tensorflow/tensorflow/cc/saved_model/reader.cc:89] Reading meta graph with tags { serve }
2025-07-09 13:42:51.199743: I external/org_tensorflow/tensorflow/cc/saved_model/reader.cc:130] Reading SavedModel debug info (if present) from: models/LSTMs/mario_lstm_savedmodel
2025-07-09 13:42:51.199825: I external/org_tensorflow/tensorflow/core/platform/cpu_feature_guard.cc:193] This TensorFlow binary is optimized with oneAPI Deep Neural Network Library (oneDNN) to use the following CPU instructions in performance-critical operations:  AVX2 FMA
To enable them in other operations, rebuild TensorFlow with the appropriate compiler flags.
2025-07-09 13:42:51.281888: I external/org_tensorflow/tensorflow/compiler/mlir/mlir_graph_optimization_pass.cc:354] MLIR V1 optimization pass is not enabled
2025-07-09 13:42:51.297923: I external/org_tensorflow/tensorflow/cc/saved_model/loader.cc:229] Restoring SavedModel bundle.
2025-07-09 13:42:51.412330: I external/org_tensorflow/tensorflow/cc/saved_model/loader.cc:213] Running initialization op on SavedModel bundle at path: models/LSTMs/mario_lstm_savedmodel
2025-07-09 13:42:51.486767: I external/org_tensorflow/tensorflow/cc/saved_model/loader.cc:305] SavedModel load for tags { serve }; Status: success: OK. Took 320993 microseconds.
Niveau sauvegardé dans levels/generated/LSTMGeneratorTF/22.txt
****************************************************************
Game Status: LOSE Percentage Completion: 0.061451048
Lives: 0 Coins: 0 Remaining Time: 20
Mario State: 0 (Mushrooms: 0 Fire Flowers: 0)
Total Kills: 0 (Stomps: 0 Fireballs: 0 Shells: 0 Falls: 0)
Bricks: 0 Jumps: 0 Max X Jump: 0.0 Max Air Time: 0
**************************************************************
000000000000000000000000000000000000000000000000000000000000000000000000000000000000000000000000000000000000000000000000000000000000000000000000000000
000000000000000000000000000000000000000000000000000000000000000000000000000000000000000000000000000000000000000000000000000000000000000000000000000000
000000000000000000000000000000000000000000000000000000000000000000000000000000000000000000000000000000000000000000000000000000000000000000000000000000
000000000000000000000000000000000000000000000000000000000000000000000000000000000000000000000000000000000000000000000000000000000000000000000000000000
000000000000000000000000000000000000000000000000000000000000000000000000000000000000000000000000000000000000000000000000000000000000000000000000000000
000000000000000000000000000000000000000000000000000000000000000000000000000000000000000000000000000000000000000000000000000000000000000000000000000000
000000000000000000000000000000000000000000000000000000000000000000000000000000000000000000000000000000000000000000000000000000000000000000000000000000
000000000000000000000000000000000000000000000000000000000000000000000000000000000000000000000000000000000000000000000000000000000000000000000000000000
000000000000000000000000000000000000000000000000000000000000000000000000000000000000000000000000000000000000000000000000000000000000000000000000000000
000000000000000000000000000000000000000000000000000000000000000000000000000000000000000000000000000000000000000000000000000000000000000000000000000000
000000000000000000000000000000000000000000000000000000000000000000000000000000000000000000000000000000000000000000000000000000000000000000000000000000
000000000000000000000000000000000000000000000000000000000000000000000000000000000000000000000000000000000000000000000000000000000000000000000000000000
000000000000000000000000000000000000000000000000000000000000000000000000000000000000000000000000000000000000000000000000000000000000000000000000000000
000000000000000000000000000000000000000000000000000000000000000000000000000000000000000000000000000000000000000000000000000000000000000000000000000000
000000000000000000000000000000000000000000000000000000000000000000000000000000000000000000000000000000000000000000000000000000000000000000000000000000
000000000000000000000000000000000000000000000000000000000000000000000000000000000000000000000000000000000000000000000000000000000000000000000000000000
Cohérence structurelle : 0.0

||||||||||||||||||||||||--||||||||--||||||||||||||||||||--||||||||||||||---||||||||||||||||XXXXX---XXXXX||||||||||||||||||||||||||||||||||||||||||||||
|||||||||||||||||||||||||-----------------------------------------------------------------------------------------------------------------------------
----------------------------------------------------------------------------------------------------------------------------------------------|||||---
%%%%-----------------------------------------------------------------------------------------------###---###-------------%%%%---%%%%--|t--------------
------------------------------%%%-----------t|%%%%----------------------------------------------------------------------------%%%%%%%%%%%%%%----------
------------------------t--------------------------%%%%%--%%%%%%%%%%%%%%%%%%%%%--%%%%%%--%%--###---###------------------------------------------------
------------------------------------------------------------------------------------------------------------------------------------------------------
------------------------------------------------------------------------------------------------------------------------------------------------------
------------------------------------------------------------------------------------------------------------------------------------------------------
------------------------------------------------------------------------------------------------------------------------------------------------------
------------------------------------------------------------------------------------------------------------------------------------------------------
------------------------------------------------------------------------------------------------------------------------------------------------------
------------------------------------------------------------------------------------------------------------------------------------------------------
--------------------------------------------------------------------------------------------||||------------------------------------%%%%--------------
------------------------------------------------------------------------------------------------------------------------------------------------------
